a	一个 每一个
abandon	遗弃 放弃 放纵自己
ability	能力 才能
able	有的能力 有本事的 能干的
aboard	在船飞机、车上 上船飞机
about	周围 大约 关于 到处 忙于
above	高于 在…之上 上述的 在上面
abroad	在国外 在海外
absence	缺席 缺乏 缺少
absent	缺席的 缺乏的 不在意的 茫然的
absolute	绝对的 完全的 确实的 肯定的
absorb	吸收 使全神贯注
abstract	抽象的 不具体的 摘要 提要
abundant	丰富的 充裕的
abuse	滥用 辱骂 虐待
academic	学院的 大学的 学术性的 理论的
academy	高等专科院校 学术社团 协会 研究院
accelerate	使加速 促进
accent	口音 音调 重音符号 重读
accept	认可 接受 相信 同意
acceptance	接受 承认 认可
access	接近 进入 从电脑中存取信息
accident	事故 意外 偶然之事
accidental	意外的 偶然发生的
accommodation	住处 膳宿
accompany	陪伴 陪同 为…伴奏
accomplish	完成 实现 成就
accord	给予 允准 使一致
accordance	一致 符合
accordingly	相应地 照着办 按照 于是 因此
account	帐目 报告 帐户 说明 报账
accountant	会计 出纳
accumulate	积累 积聚 堆积 积蓄
accuracy	准确 精确
accurate	准确的 精确的 正确无误的
accuse	谴责 指控
accustomed	 习惯了的
ache	疼 疼痛 持续的隐隐作痛
achieve	完成 达到目的
achievement	成绩 成就 完成 达到
acid	酸的 酸性的 酸
acknowledge	承认 对某人所做的事表示感谢
acquaintance	认识 了解 熟人 相识的人
acquire	获得 取得 学到知识等 养成习惯
acquisition	获得物
acre	英亩
across	横过 在…的对面 横过 在另一边
act	行动 起作用 扮演 行为 法令
action	活动 行为 作用
active	有活力的 积极的 主动的
activity	活动 行动
actor	演员 男演员 行动者
actress	女演员
actual	实际的 现实的 真实的 目前的
acute	剧烈的 敏锐的 成锐角的 尖的 高音的
ad	广告
adapt	使适应 使适合 改写 改编
add	加上 增加 合计 补充
addition	加 加法 附加物
additional	附加的 另外的
address	地址 讲话 向…讲话 写姓名地址
adequate	足够的 充分的
adjective	形容词 形容词性的
adjust	调整 校准 调整 适应于
administration	管理 经营 管理部门 执行 施政
admire	羡慕 赞美 钦佩
admission	允许进入 承认 入场费 入会费 入场券
admit	承认 接纳 招收
adopt	采用 采取态度等 选定 收养
adult	成年人的 已成熟的 成年人
advance	前进 进展 促进 提高 发展 前进
advanced	先进的 高级的
advantage	优点 有利条件 利益 好处
adventure	冒险 冒险活动 奇遇
adverb	副词
advertise	做广告
advertisement	广告 做广告 登广告
advice	劝告 意见 建议
advisable	明智的 可取的
advise	劝告 建议 警告 忠告
advocate	提倡 鼓吹 提倡者 鼓吹者
aeroplane	英飞机
affair	事件 事务 业务 私通
affect	影响 作用 感动 疾病侵袭
affection	慈爱 爱 感情 作用 影响
afford	担负得起 抽得出时间等 提供
afraid	害怕的 畏惧的 恐怕的 担心的
after	在…后 后来
afternoon	下午 午后
afterward	以后 后来
again	又 再 倍
against	逆 紧靠着 与…对照 对比
age	年龄 时代 老年 长时间 使变老
agency	代理权 代办 力量 能动作用 机构
agenda	会议的议程
agent	代理人 代理商 产生作用的人或事物
aggressive	爱寻衅的 侵略的 有进取心的
ago	以前 …前
agree	赞同 适合 一致 商定
agreement	协议 约定 同意 达成协议
agriculture	农业
ahead	在前 向前 在先 预先
aid	帮助 助手 救护 帮助 急救
aim	目的 瞄准 目的在于 把…瞄准
air	大气 空气 态度 神态 通风
aircraft	飞机 飞艇 航空器
airline	飞机的航线 航空公司
airplane	美飞机
airport	飞机场
alarm	惊恐 警报 使…惊恐 向…报警
alcohol	酒精 乙醇 含酒精的饮料
alert	警惕的 警觉的 机灵的
alike	相同的 相像的
alive	活着的 存在的 有活力的 活泼的
all	全部的 整个的 全部 完全 都
alliance	同盟 同盟国 结盟 联姻
allocate	分配 配给
allow	允许 准许 承认 给予 考虑到
allowance	津贴 零用钱
ally	同盟者 伙伴 同类
almost	几乎 差不多
alone	单独的 独自的 仅仅 只 单独地
along	沿着 向前
alongside	在…旁边 和…在一起 在旁边
aloud	大声地 响亮地
alphabet	字母表
already	早已 已经
also	也 同样 而且 还
alter	改变
alternative	两者择一的 供选择的东西 取舍?
although	虽然 即使
altitude	高度 海泼
altogether	完全 总之 总共
aluminium	铝
aluminum	铝
always	总是 一向 始终 永远
amateur	业余的 业余爱好者
amaze	使惊愕
ambassador	大使 特使
ambition	野心 雄心 抱负 志向
ambulance	救护车船、飞机等
amid	在…中 在…当中
among	在…之中 在一群组之中 于…之间
amongst	在…之中三者以上
amount	数量 总数 总计 相当于 等于
amuse	逗乐 使开心 给…提供娱乐
analyse	分析 分解
analysis	分析 分解
analyze	分析 分解
ancestor	祖宗 祖先
anchor	锚 靠山 固定 抛锚 停泊
ancient	古代的 古老的
and	 和 而且 那么 然后 加
anger	怒 愤怒　激怒
angle	角 角度 看问题的角度 观点
angry	发怒的 愤怒的
animal	动物的 兽类的
ankle	踝 踝节部
anniversary	周年 周年纪念
announce	宣布 通告 报告…的来到
annoy	使烦恼 使生气 打扰
annual	每年的 年度的 年刊 年鉴
another	另一个 又 再 另一个 类似的一个
answer	回答 答案 回答 响应 符合 解答
ant	蚁
anticipate	预料 预期
antique	古代的 旧式的 古物 古董
anxiety	挂念 焦虑 渴望
anxious	焦虑的 发愁的 急切的 使人不安的
any	一些 任何的 任何一个 无论哪个
anybody	某人 无论谁 任何人
anyhow	不管怎样说 不管以什么方法 总之
anyone	任何人
anything	无论什么事 任何东西 任何事物
anyway	不管怎样
anywhere	无论哪里 任何地方用于否定、疑问等
apart	相距 相隔 分 离开 除去
apartment	公寓住宅 套间
apologise	道歉
apologize	道歉 认错 辩护 辩解
apology	道歉 认错 辩解 辩护
apparent	明显的 表面上的
appeal	请求 吸引 上诉 呼吁 吸引力 申诉
appear	出现 露出 似乎 好象
appearance	出现 出场 外貌 样子
appetite	食欲 胃口 爱好 嗜好 欲望
applause	鼓掌欢迎 欢呼
apple	苹果
appliance	器具 器械 装置
applicable	可应用的 适当的 合适的
applicant	申请者
application	申请 申请表格 应用 实施
apply	申请 应用 把…应用于
appoint	任命 委派 指定 约定时间、地点等
appointment	约定 约会 任命 委派
appreciate	感激 感谢 评价 欣赏 充分意识到
approach	接近 方法 走近 与…接洽 探讨
appropriate	恰当的 合宜的 拨给 挪用 盗用
approval	赞成 批准
approve	批准 通过 赞许 同意
approximate	大致的 近似的 接近 近似
april	四月
arbitrary	任意的 武断的 专断的 专横的
architect	建筑师 缔造者
architecture	建筑学 建筑式样 结构 构造
area	地区 面积 范围 领域
argue	辩论 争论 辩论 论证 说服 劝说
argument	辩论 争论 论点 论据
arise	出现 发生 由…引起 起源于 起来
arithmetic	算术
arm	手臂 支架 武器 武装 装备
army	军队 一大批 一大群
around	周围 在近处 大约 在…周围
arouse	唤醒 叫醒 唤起 激起
arrange	安排 整理 安排 准备
arrangement	排列 整理 安排 准备
arrest	逮捕 扣留 逮捕 扣留 阻止 吸引
arrival	到达 抵达 到达者
arrive	到来 到达 达成 得出
arrow	箭 箭状物 箭头记号
art	艺术 美术 技艺 技术 文科 艺术品
article	文章 论文 物件 物品 条款 冠词
artificial	人工的 人造的 人为的 假的
artist	艺术家 美术家 某方面的能手
artistic	艺术家的 美术家的 善于艺术创作的
as	由于 像 作为 同样地
ash	灰 灰末 骨灰 废墟
ashamed	惭愧的 羞愧的
aside	在旁边 到一边 旁白 离题的话
ask	问 请求 邀请 问 要求
asleep	睡着的 睡熟的
aspect	问题等的方面 样子 面貌
assemble	集合 装配 聚集 集会
assembly	集合 集会 会议 装配 组装
assess	估价 评价
asset	资产 财产 有价值的东西
assign	派给 分配 选定 指定时间、地点
assignment	分派 分配 作业 任务
assist	帮助 援助
assistance	帮助 援助
assistant	帮助的 辅助的 助手 辅助物
associate	使发生联系 交往 合伙的 合伙人
association	协会 社团 联合 合伙
assume	设想 假定 装出…样子 承担 接受
assumption	假定 设想 假装
assure	使确信 使放心 保证 担保
astonish	使大吃一惊
at	在…时 在…中 在…方面 向 朝
athlete	运动员
atmosphere	大气层 气氛 环境
atom	原子 微量 微粒
atomic	原子能的 关于原子的
attach	贴上 系上 附上 附属
attack	攻击 袭击 病发作
attain	达到 取得
attempt	企图 试图　尝试 试图
attend	出席 照顾 护理 注意 专心
attention	注意 留意 立正
attitude	态度 看法
attorney	律师
attract	吸引 引诱
attraction	吸引 吸引力
attractive	吸引人的 引人注意的 漂亮的 迷人的
attribute	把…归于 认为是…的结果 属性
audience	听众 观众
audio	音频的 音响的 声音的
august	八月
aunt	伯母 婶母 姑母 姨母 舅母
author	作家 著者
authority	权力 官方 当局
auto	汽车
automatic	自动的 机械的 无意识的
automobile	汽车 机动车
autumn	秋 秋季 成熟期 渐衰期
auxiliary	辅助的 备用的
available	用于物可利用的 可见到的 接受采访的
avenue	林荫道 大街 喻途径 手段　
average	平均 一般水平 平均的 一般的
avoid	避免 逃避
await	等待 等候
awake	唤醒 使觉醒 醒来 醒悟 醒着的
award	奖 奖品 授予 奖给
aware	意识到的 知道的
away	离开 远离
awful	可怕的 极坏的
awkward	尴尬的 笨拙的 使用不便的 棘手的
baby	婴儿 年龄最小的人 幼畜或雏鸟
back	背面 后部 朝后面 回去 支持?
background	背景 经历
backward	向后的 落后的 向后地 倒 逆
bacon	熏猪肉
bacteria	细菌
bad	坏的 有害的 严重的
badly	坏地 严重地 非常
bag	袋 口袋 手提包 钱包
baggage	行李
bake	烘烤 烧硬 焙干
balance	均衡 收付平衡 使保持平衡
balcony	阳台 剧院的楼座 二楼包厢
ball	球 球状物 正规的大型舞会
balloon	气球 如气球般膨胀
ban	禁止
banana	香蕉
band	乐队 带 波段　缚 捆绑
bang	猛敲 猛撞 发出砰的响声 砰地
bank	银行 库 堤 岸
bankrupt	破产的 使破产 破产者
banner	旗 旗帜 政治性的横幅标语
bar	酒吧 横木 障碍 B律师业　闩上
barber	理发师
bare	赤裸的 极少的 仅有的
barely	贫乏地 仅仅 几乎没有
bargain	讨价还价 便宜货 买卖合同 交易
bark	狗叫声 狗吠叫似的声响 吠
barn	谷仓 饲料仓 牲口棚
barrel	圆木桶 枪管
barrier	栅栏 屏障 障碍物
base	基础 底部 基地 根据地 以…为根据
baseball	棒球 棒球运动
basic	基本的 基础的
basically	基本上 根本地
basin	盆 脸盆 盆地 流域
basis	基础 基底 根据 基准
basket	筐 篮 篓
basketball	篮球运动
bat	球拍 蝙蝠 用棒击 打击球
bath	洗澡 浴缸 浴盆
bathe	洗澡 洗澡 游泳
bathroom	浴室
battery	电池组 器具等的一组 一套 炮兵连
battle	战斗 作战 战斗 作战 斗争
bay	海湾
be	是 在 就是
beach	海、河、湖滩 海滨
beam	横梁 光线 容光焕发 放光 面露喜色
bean	豆 菜豆
bear	熊 粗鲁的人 笨拙的人
beard	胡须
bearing	轴承 意义 举止
beast	四足兽类 牲畜 凶残的人
beat	打 敲 打败 打 敲 心脏等跳动
beautiful	美丽的 美好的
beauty	美丽 美女 美好的事物
because	因为
become	变成 变得
bed	床 花坛 河床
bee	蜂 蜜蜂
beef	牛肉
beer	啤酒
before	在…以前 以前 从前
beg	乞讨 乞求
beggar	乞丐
begin	开始
beginning	开始 开端 起源 起因
behalf	利益
behave	举动 表现 运转 使运转正常
behavior	行为 表现 机器等的运转情况
behaviour	行为 举止 机器的运转情况
behind	在…后面 迟于 在后 迟 慢
being	存在 生存 存在物 生物 生命 人
belief	相信 信任 信念 信仰
believe	相信 认为 相信 信任 信奉
bell	铃 门铃 钟声
belong	属于 归类于
beloved	被热爱的 爱人 心爱的人
below	在…以下 在…下面 在下 下面
belt	腰带 带状物 地带 区域
bench	凳 长凳
bend	使弯曲 使屈服
beneath	在…下面下方 紧靠着…底下
beneficial	有益的 有用的
benefit	利益 救济金 有益于 受益于
beside	在…旁边 在…附近 与…相比
besides	而且 此外 除…之外还
best	最好的 最好地 最好的人东西等
bet	打赌 赌注 打赌 赌 确信 敢说
better	较好的 更好地 较优者 改善
between	在…之间 在两者之间 在中间
beyond	在…之外 超出…范围 胜过 迟于
bible	圣经
bicycle	自行车
bid	投标 拍卖时的出价
big	大的 重要的 宽宏大量的 大受欢迎的
bike	自行车
bill	账单 支票 招贴 钞票 给 …开账单
billion	美十亿 英万亿
bind	捆, 包扎 装订 约束 使凝固 变硬
biology	生物学
bird	鸟 禽
birth	出生 诞生 出身 血统 起源 出现
birthday	生日 诞辰
biscuit	饼干
bit	一点 比特二进位制信息单位
bite	咬 叮 刺骨 叮 咬 吃一口
bitter	辛酸的 辛苦的 有苦味的 严寒的
black	黑色的 黑暗的 黑色 黑人
blackboard	黑板
blade	刀刃 刀片 桨叶 草叶 叶片
blame	责怪 把…归咎于 责备 过错
blank	空白 表格 空白的 无表情的
blanket	毛毯 毯子 覆盖 布满 弥漫
blast	炸毁 摧毁 爆炸 爆破 一阵 汽笛声
bleed	使流血 从…取血 从…抽取液体或空气
blend	掺和 混合
blind	盲的 盲从的 使变瞎
block	大块石料等 街区 阻塞物 阻拦
blood	血液 血 血统 血亲 血气
bloody	流血的 血腥的
bloom	花 花期 开花 容光焕发 显露出健康
blouse	女衬衫 童衫 罩衫
blow	打 风吹 吹动 使爆炸 响起 输
blue	蓝色的 脸色发灰的 忧郁的 蓝色
board	板 委员会 上车船 包饭
boast	夸耀 以有…而自豪
boat	小船 船形物 划船
body	身体 主体 尸体 物体 大量
boil	沸腾 煮沸
bold	勇敢无畏的 冒失的 粗体的 粗体
bolt	闪电 霹雳 插销 门闩 螺栓
bomb	炸弹 高压喷雾器 投弹 轰炸
bond	联系 约束 公债 票据 使结合 使粘
bone	骨头 骨状物
book	书本 书籍 手册 卷 册 预定票等
boom	发出隆隆声 繁荣 兴隆起来
boost	提高 增加
boot	长统靴 汽车后部放行李处 踢
border	边 边缘 边界 和…接连 近似
bore	孔 讨厌的人 钻孔 使人烦
boring	令人厌烦的 钻孔
born	出生的 天生的
borrow	借 借入 思想、文字等采用 抄袭
boss	老板 上司 指挥 对…发号施令
both	两个…都 两者都
bother	打扰 麻烦 费心 麻烦 讨厌的人
bottle	瓶子 流体容器
bottom	底 底部 臀部 末端 尽头 来源
bounce	弹起来 使弹起 弹 反弹
bound	跳 边界 弹跳 限定 开往…
boundary	分界线 边界
bow	弓 蝴蝶结 鞠躬 点头 用弓拉琴
bowl	碗 钵
box	盒子 箱子 戏院的包厢
boy	男孩 侍者 服务员
brain	大脑 心智 智力
brake	闸 刹车 制动器 刹车
branch	树枝 分枝 机构的分部 学科的分科
brand	商标 烙印 打烙印于… 铭刻
brass	黄铜 黄铜制品
brave	勇敢的 英勇的
bread	面包 食物 生计
breadth	宽度 广度
break	打破 中断 破 断裂 中断 间歇
breakfast	早饭
breast	胸脯 乳房 胸部 挺胸迎…而上
breath	气息 呼吸 风微动
breathe	呼吸
breed	种类 品种 繁殖 饲养 引起
breeze	微风
brick	砖 砖状物 方木块 块料
bride	新娘
bridge	桥 桥梁 桥牌
brief	短暂的 简洁的 摘要 概要
bright	明亮的 欢快的 聪明的 颜色鲜艳的
brilliant	很明亮的 光辉的 辉煌的 卓越的
bring	拿来 带来 产生 导致 引来 提出
broad	宽的 宽容的 粗略的 概括性的 敞开的
broadcast	广播 广播节目 用无线电或电视广播
broom	 扫帚
brother	兄弟 同胞 教友 同事
brow	眉毛 额
brown	棕色的 褐色的
brush	刷 毛刷 刷子 画笔
bubble	水泡 气泡 冒泡 沸腾
bucket	水桶
budget	预算 预算案 预算额 经费 生活费
build	建造 建筑 建设 建立 增大 增强
building	建筑物 房屋
bulb	电灯泡 球状物
bulk	容积 体积 大块 大批 大部分 大多数
bullet	子弹
bump	碰撞 颠簸 肿块 碰撞 颠簸　
bunch	一串 一束
bundle	包裹 包袱 一包 一捆 一束
burden	负担 负重 负荷 载重 义务 责任
bureau	司 局 处 社 所
burn	燃烧 烧毁 烧伤 灼伤
burst	爆炸 破裂 突然发生
bury	埋葬 掩埋 掩盖
bus	公共汽车
bush	矮树丛 灌木丛
business	生意 业务 事务 职责 企业
busy	忙的 热闹的 电话占线
but	但是 除…以外 仅仅
butcher	卖肉的人 屠夫
butter	黄油 脂样的物质
butterfly	蝴蝶 蝶形
button	钮扣 按扭 扣上扣子 扣紧
buy	买 购买 收买
by	靠近 不迟于 在近旁
cab	出租马车
cabbage	洋白菜 卷心菜
cabin	船舱 机舱 小木屋
cabinet	橱 柜子 内阁
cable	缆 电缆 电报 打电报
cage	笼子
cake	饼 糕 蛋糕 扁平的块状物
calculate	计算 推测 估计 打算 计划
calculator	计算器
calendar	日历 月历
call	叫 喊 打电话 叫 访问 叫 号召
calm	平静下来 使平静 天气等平静的
camel	骆驼
camera	照相机 摄影机 摄像机
camp	营地 野营 宿营 扎营
campaign	战役 运动 竞选运动 领导 发起运动
campus	大学校园
can	容器 听 罐头 把食品装罐
canal	运河 沟渠
cancel	取消 作废 删去 划掉
cancer	癌症 肿瘤
candidate	候选人 候补者 投考者 求职者
candle	蜡烛
candy	美糖果
cap	帽子 盖子 盖住 胜过 优于
capable	有能力的 有才能的 能做到的 有可能的
capacity	容量 容积 能力 性能
capital	首都 大写 资本 大写的 可判死刑的
captain	船长 机长 陆军上尉 海军上校
capture	捕获 俘获 夺取 占领
car	车 汽车 火车车厢
carbon	碳
card	卡 卡片 名片 纸片 纸牌 纸牌游戏
care	小心 忧虑 烦恼 照料 关心 计较
career	生涯 职业
careful	当心的 小心的 仔细的
careless	粗心的 疏忽的
cargo	船货 货物
carpenter	木工, 木匠"
carpet	地毯
carriage	车辆 车厢
carrier	运载工具 带菌者 货运商
carrot	胡萝卜
carry	运 送 搬 传播 输送
cart	手推车, 板车
cartoon	卡通片 动画片 报刊上的漫画 连环画
case	情况 事实 案例 箱 盒
cash	现金 现钱 兑换成现金
cashier	 出纳员
cassette	盒子 盒式磁带
cast	投 扔 撒网 铸造 一投 撒网
castle	城堡
casual	偶然的 临时的 非正式的 草率的
cat	猫 猫科动物
catalog	目录 对…编目
catalogue	目录 目录册
catch	抓住 赶上 听懂 引起注意 染上
category	种类 范畴
cattle	牲口总称 尤指牛
cause	原因 理由 事业 奋斗目标 引起
cautious	小心谨慎的
cave	山洞, 洞穴"
cease	停止 终止
ceiling	天花板 顶篷
celebrate	庆祝 赞扬 称颂
cell	细胞 电池 小房间 小牢房
cement	水泥
cent	分币 作单位的百
center	中心 核心 居中 使集中
centigrade	摄氏温度
centimeter	公分 厘米
centimetre	公分 厘米
central	中心的 主要的
centre	中心 中间派 活动的集中地点 集中
century	一百年 世纪
ceremony	典礼 仪式 礼节 礼仪
certain	肯定的 必然的 某一 某种
certainly	一定 必定 当然可以 行
certificate	证书 证明书
chain	链 链条 一连串 用链条拴住 束缚
chair	椅子 会议主席 大学教授 主持会议
chairman	主席 议长
chalk	白垩 粉笔
challenge	挑战 艰巨任务 向…挑战 对…表示怀疑
chamber	房间 室 会议室 议院 动物体内腔室
champion	冠军 捍卫者 捍卫 拥护
chance	机会 可能性 偶然性 碰巧 冒险试
change	改变 交换 改变 变化 交换 零钱
channel	渠道 通道 管道 海峡 频道
chaos	混乱 纷乱
chap	家伙 小伙子
chapter	章 回 篇 历史上的一段时间
character	个性 品质 特性 人物 字母 书写符号
characteristic	特有的 典型的 特色 特性
characterize	描绘…的特征 刻划…的性格
charge	装满 收费 控告 充电 收费 罪名
charity	仁慈 宽厚 慈善机关团体
charm	魅力 美貌 符咒 迷住 对…施魔法
chart	图 图表 航线图
charter	宪章 特许权 特许 发执照给… 租
chase	追逐 追赶
chat	聊天 闲谈
cheap	便宜的 劣质的 虚伪的 便宜地
cheat	欺骗 诈取 作弊 欺骗行为 骗子
check	检查 阻止 检查 阻止 支票 帐单
cheek	面颊 脸蛋 无耻的行为 粗鲁地向…讲
cheer	使高兴 欢呼 欢呼 喝彩 振奋
cheerful	高兴的 使人愉快振奋的
cheese	乳酪 干酪
chemical	化学的 化学制品
chemist	化学家 英药剂师
chemistry	化学
cheque	支票=[美作:]
chess	象棋 国际象棋
chest	箱子 柜子 胸膛 胸腔
chew	咀嚼
chicken	小鸡 鸡肉
chief	元首 主要的 首席的
child	儿童 孩子
childhood	童年
chill	寒气 寒冷 使寒冷 使冷冻
chimney	烟囱 烟道
chin	下巴 颏
china	瓷器
chip	片屑 缺口 马铃薯片 弄出缺口
chocolate	巧克力糖 深褐色的
choice	选择 抉择 选择权 供选择的东西
choke	窒息 阻塞 抑制
choose	挑选 选择 愿意 决定
chop	排骨 肉块 砍击 砍 劈 斩
christ	耶稣 基督
christian	基督教教徒　基督教的 具有基督的精神
christmas	圣诞节
church	教堂 C-教会
cigar	雪茄烟 叶卷烟
cinema	电影院 影片 电影
circle	圆 圈子 周期 环绕 围绕…画圈
circuit	线路 电路 一圈 周线 巡回 巡行
circular	圆形的 循环的 传单 报单 通知
circulate	使循环 使流通 使传播
circumstance	情况 境况
cite	引用 引证 传讯
citizen	公民 市民 居民
city	城市 都市
civil	国民的 国内的 文明的 文职的 民用的
civilian	市民 老百姓 平民的 民用的
civilisation	文明 文化 开化 教化
civilise	使文明 使开化
civilization	文明 文化 开化 教化
civilize	使文明 使开化
claim	权力 要求 主张 声明 要求 索取
clap	拍 拍手喝彩 掌声 劈雳声
clarify	澄清 阐明 使明晰
clash	发出铿锵声 意见等冲突 铿锵声
class	班级 阶级 一堂课 门类
classic	传统的 最优秀的 杰作 名著
classical	古典文学的 经典的 人文科学的 文科的
classification	分类 分级
classify	分类 分等级
classmate	同班同学
classroom	教室 课堂
clause	条款 款项 分句 从句
claw	爪
clay	粘土 泥土
clean	干净的 清洁的 擦干净 把…弄干净
clear	光亮的 条理清楚的 清除 使明白
clerk	职员 店员 办事员 法庭中的书记
clever	聪明的, 灵巧的"
click	一击 咔哒声 发出咔哒声
client	委托人 当事人 顾客
cliff	悬崖 峭壁
climate	气候
climb	攀登 爬 攀登 爬 攀登的地方
clinic	诊所
clock	钟
close	关 结束 距离近的 接近 结束
cloth	布 织物 衣料
clothes	衣服
clothing	衣服总称
cloud	云 一缕 一群 阴影
cloudy	多云的 阴天的 似云的 模糊不清的
club	俱乐部 棍棒 球棒 用棍棒打
clue	线索 提示
clumsy	笨拙的
coach	教练 火车客车车厢 训练 辅导
coal	煤 煤块
coarse	粗糙的 粗劣的
coast	海岸 海滨
coat	上衣 外套 涂层 动物的毛皮 涂上
cock	公鸡 龙头 枪板机 竖起
code	法规 代码 把…译成电码 把…编成号
coffee	咖啡 咖啡色
coil	卷 盘绕 一卷 圈 圈线
coin	硬币 钱币 杜撰新词等 铸造
cold	寒冷的 冷淡的 伤风 感冒 寒冷
collapse	使倒塌 使崩溃
collar	衣领
colleague	同事 同僚
collect	收 收集 聚集 堆积
collection	收集 搜集 采集 收藏品
collective	集体的 共同的 集体 全体人员
college	大学 学院
collision	碰撞 冲突
colony	殖民地 同类人的聚居地
color	颜色 颜料 脸色 肤色 给…着色
colour	颜色 颜料 脸色 肤色 给…着色
column	柱 柱状物 专栏文章 直行
comb	梳 梳理 梳子
combat	与…战斗 搏斗 战斗 斗争 搏斗
combination	联合 合并 化合 化合物
combine	结合 联合 化合 集团 联合收割机
come	来 到来 出现 成为 是
comedy	喜剧 喜剧场面
comfort	使安慰 使舒服 安慰 舒适 安逸
comfortable	舒适的 舒服的
command	命令 吩咐 控制 管辖 掌握
commander	指挥官 司令官 海军中校
comment	评论 评论 意见
commerce	商业 贸易
commercial	商业的 可获利的 广告节目
commission	委托 授权 委员会 拥金 回扣 委任状
commit	犯错误 罪行等 把…托付给 提交
commitment	承担义务 许诺
committee	委员会
common	普通的 寻常的 共有的 公共的
communicate	交际 交流思想等 传达 传送 通讯
communication	通讯 交流 传达 通信系统
communism	共产主义 共产党政体
communist	共产主义者 共产党员 共产主义的
community	社区 市民大众 共有 共同性
companion	同事 同伙 同伴 伴侣
company	公司 商社 陪伴 伴随 交往 一伙
comparable	可比较的 比得上的
comparative	比较的 形容词或副词的比较级
compare	比较 对照 比作 比喻
comparison	比较 对照 比喻
compass	指南针
compel	强迫 迫使
compete	竞争 竞赛
competent	有能力的 能胜任的 足够的
competition	比赛 竞赛
competitive	竞争的 比赛的
complain	抱怨 拆苦 投诉
complaint	抱怨 诉苦 发牢骚
complete	完整的 已完成的 彻底的 完成 结束
complex	复合的 复杂的 综合企业 复合体
complicated	复杂的
component	尤指机器或系统的组成部分 构成的
compose	构成 组成 创作乐曲、文学作品等
composition	构成 成分 作文 作曲 音乐等作品
compound	化合物 混合物 复合的 合成的
comprehension	理解 理解力 领悟
comprehensive	广泛的 综合的
compress	压缩 紧缩
comprise	包含 由…构成 构成 组成
compromise	妥协 折衷方案 妥协 危及 连累
computer	计算机 电脑
comrade	同志 朋友 同事
conceal	隐藏 隐瞒
concede	承认 给予 割让
concentrate	聚中 浓缩 浓缩物
concentration	专注 专心 集中 浓缩
concept	概念 观念
concern	所关切的事 关心 与…有关 使担心
concerning	关于
concert	音乐会 演奏会 一致
concession	让步 妥协
conclude	结束 下结论 推论 缔结 议定
conclusion	结论 推论 结尾 结束语
concrete	混凝土 具体物 混凝土制的 具体的
condemn	遣责 判刑 宣告有罪
condense	压缩 浓缩 精简
condition	条件 状态 状况 环境 形势
conduct	行为 表现 品行 引导 处理 传导
conductor	售票员 列车员 乐队的指挥 导体
conference	正式会议 讨论会
confess	坦白 供认 承认
confidence	信心 信任
confident	确信的 自信的
confine	限制 使局限于 使闭门不出 禁闭
confirm	证实 进一步确定 批准 使坚固
conflict	斗争 冲突 斗争 战斗 抵触 冲突
confront	使面临 使遭遇 使对质 面对危险等
confuse	使混乱 使困惑 混淆 混同
confusion	混淆 混乱 困惑 糊涂
congratulate	祝贺 恭贺 向…道贺
congratulation	祝贺 祝贺词
congress	代表大会 美国国会 议会
conjunction	联合 连接 接合 连接词
connect	连接 与…联系 连接 相通
connection	连接 联络工具 亲属、社会上的关系
connexion	 连接,团体,连贯性客户,亲戚
conquer	征服 占领 克服 改正恶习等
conquest	攻取 征服
conscience	良心 道德心
conscious	有意识的 意识到的 神志清醒的 有意的
consent	同意 赞成 同意 赞成
consequence	结果 后果
consequently	所以 因此
conservation	保存 ??守恒
conservative	保守的 小心谨慎的 防腐的 保守的人
consider	认为 把…看作 考虑 考虑 细想
considerable	值得考虑的 相当大、多的
considerate	 体谅的
consideration	考虑 需考虑到的事 体谅 关心
consist	存在于 由…组成 构成 包括
consistent	一致的 符合的 坚持的 相容的
constant	固定不变的 经常发生的 不变的事物
constitute	构成 制定
constitution	法规 宪法 章程 组织 构造 体质
construct	建设 建造 创立
construction	建造 构造 建筑物 结构 释义 解释
consult	请教 向…咨询 查阅 就诊 商议
consultant	顾问 专家 医院的高级专科顾问医生
consume	消费 花费 毁灭 耗尽 消费掉
consumer	用户 消费者
consumption	消费 消耗 消费额 消耗量 肺病
contact	接触 联络员 带菌者 接触 联系
contain	包含 含有 克制 抑制
container	容器 集装箱
contemporary	当代的 同龄的 同代人 同龄人
content	目录 满足 满足的 使满足
contest	竞争 比赛 竞争 比赛 争论 争辩
context	上下文 事情等的前后关系 情况
continent	不停的 频频的
continual	不断的 频繁的
continue	持续 继续
continuous	连续的 不间断的
contract	契约 合同 订约 使收缩
contradiction	矛盾 反驳
contrary	相反的 相反的事物 对立面
contrast	对照 对比 对立面 反差 使对照
contribute	捐献 贡献 捐款 投稿 起一份作用
contribution	贡献 捐献 捐献物 投稿
control	控制 抑制 支配
controversial	引起争论的 有争议的
controversy	争论 争议
convenience	方便 便利 有益的工具 便利设备 公厕
convenient	方便的
convention	会议 大会 惯例 习俗 公约 协定
conventional	普通的 常见的 习惯的 常规的
conversation	会话 谈话
conversely	 1 相反地
convert	使转变转化 改变信仰 皈依者
convey	传达 表达 传送 运输
convict	证明…有罪 使…知罪 罪犯
conviction	确信 信服 坚信 坚定的信念
convince	使确信 使相信
cook	煮 烧食物 做饭 厨师
cool	凉的 沉着的 使冷却 使冷静
cooperate	合作 协作
coordinate	同等的 协调的 同等者 协作 协调
cop	警察
cope	"竞争 应付, 处理
copper	铜 铜币 铜器 铜制的 紫铜色的
copy	抄本 书的一册 抄写 复印 复制
copyright	版权 著作权
cord	绳 线 纺织品 小电线 腱
core	果心 核心 要点
corn	谷物 美玉米 英小麦
corner	角落 街角 困境
corporation	公司 市政府
correct	正确的 合适的 改正
correspond	对应于 符合 通信
correspondence	通信 信件 符合 一致 相当 相应
correspondent	通信者 记者 通信员 对应物
corresponding	相应的 相当的
corridor	 走廊 通道
cost	成本 代价 花费 使失去生命等
costly	昂贵的 浪费的
cottage	农舍 小屋 小型别墅
cotton	棉 棉花 棉线 棉制品
cough	咳嗽 咳出
could	的过去式 可能 用来表示请求
council	委员会 理事会
counsel	忠告 劝告 辩护人 忠告 劝告
count	数 计算 认为 有价值 计数 总数
counter	柜台 相反的 反对 反方向地
country	国家的 农村的
countryside	乡村
county	英国县或郡 美州以下最大的行政区
couple	一对 夫妇 两三个 连接 结合
courage	勇气 胆量
course	过程 进程 一道菜 课程 教程
court	法院 法庭 球场 朝廷 院子
courtyard	庭院 天井
cousin	堂表弟 堂表姐妹 同种同族
cover	覆盖 涉及 经过 覆盖物 掩护物 罩
cow	母牛 奶牛
crack	破裂声 裂缝 发出爆裂声 使破裂
craft	工艺 手艺 船 航空器
crane	起重机 鹤 引颈 伸长脖子
crash	碰 坠毁 横冲直撞 破产 碰撞 失败
crawl	爬行 伏地行进
crazy	疯的 荒唐的 狂热的 着迷的
cream	奶油 精华 淡黄色 搅拌成奶油状
create	创造 产生
creative	创造性的 有创造力的
creature	生物 动物 人
credit	信用 赊欠 学分 信任 把…记入贷方
creep	爬 蠕动 爬 蔓延 潜行
crew	全体船员 机组人员 乘务员
crime	罪 犯罪
criminal	刑事的 犯罪的 罪犯 刑事犯
crisis	?关?
critic	批评家 评论家
critical	批评的 批判的 危急的 关键的 苛求的
criticise	批评 评论 非难
criticism	批评 评论
criticize	批评 评论 非难
crop	庄稼 收成 一批 收割 收成 耕种
cross	十字架 交叉路 穿越 相交 划横线
crossing	横渡大海 河流等 河流渡口
crowd	群 人群 群众 挤满 聚集 群集
crown	王冠 王权 顶部 给…加冕 覆盖
crucial	关键的 决定性的
crude	天然的 粗鲁的 粗糙的 原油
cruel	残酷的 残忍的 痛苦的
cruise	巡航 巡游
crush	压碎 榨
crust	 硬皮
cry	叫 喊 哭 鸟兽叫 啼 鸣 嗥
crystal	水晶 石英晶体 晶粒 水晶的
cube	立方体 立方形 立方 使自乘两次
cue	给演员等所作的提示 提词 暗示 指引
cultivate	耕作 培养 种植
culture	文化 教养 修养
cup	杯子 奖杯 一杯的容量 高尔夫球球洞
cupboard	食橱 碗橱
cure	治愈 治疗
curiosity	好奇心
curious	好奇的
curl	使卷曲 卷发 卷曲物
currency	通货 货币 流通 流行
current	现时的 通用的 水、气、电流 趋势
curriculum	学校、专业的全部课程 必修课程
curse	诅咒 祸因 骂人的话 诅咒 遭受…苦
curtain	窗、门帘 舞台的幕
curve	曲线 弯曲 弄弯 弯曲
cushion	垫子 坐垫
custom	习惯  C海关 关税
customer	顾客, 主顾
cut	切 割 削减
cycle	循环 周期 自行车 使轮转
daily	每日的 日报
dairy	牛奶场 乳品店 乳制品 牛奶的
dam	堤 坝 筑坝
damage	损坏 毁坏 赔偿金 损坏 毁坏
damn	该死 遣责 使失败 十足的 极
damp	潮湿的 打湿
dance	跳舞 舞蹈 舞会
danger	危险 危险物 威胁
dangerous	危险的
dare	敢 竟敢 向…挑战 激 胆敢 敢
dark	黑暗的 深色的 秘密的 黑暗 暗处
darling	可爱的 有魅力的 心爱的人 乖乖
dash	猛冲 猛冲 猛冲 短跑 破折号
data	资料 数据
date	日期 约会 给…注明日期 起
daughter	女儿
dawn	黎明 开始 破晓 开始出现
day	一日 白天
daylight	日光 白昼 黎明
dead	死的 无知觉的 无声响的 完全地
deadline	截止时间 截止日期
deaf	聋的 不愿听的
deal	处理 对付 分给 给予 交易
dear	亲爱的 珍贵的 昂贵的 啊 亲爱的
death	死亡
debate	辩论 争论 辩论 争论 考虑 思考
debt	债务
decade	十年 十
decay	衰退 腐败 使衰退 使腐败
deceive	欺骗 蒙骗
december	十二月
decent	庄重的 正派的 大方的 服装等相称的
decide	决定 决心 裁决 解决 选定
decision	决定 决心
deck	甲板 桥面 层面
declaration	宣布 宣告 宣言
declare	宣告 宣布 声明 断言 申报纳税物品
decline	下降 倾斜 衰败 拒绝 衰落 下降
decorate	装饰 布置 授…以殊荣
decrease	减少 减弱 降低
deed	行为 行动 功绩 事迹 契约 证书
deep	深的 深刻的 深奥的 强烈的 深深地
deer	鹿
defeat	战胜 挫败 击败 战胜
defect	缺点 缺陷 变节 投敌 脱党
defence	保卫 防御工事 答辩
defend	保卫 防卫 为…辩护
defense	保卫 防御工事 答辩
define	解释 给…下定义 限定
definite	明确的 肯定的
definitely	一定地 肯定地 明确地 确切地
definition	定义 解释 轮廓等的清晰
degree	度数 程度 学位
delay	推迟 耽误
delegate	代表 授权 委托
delete	删除
deliberate	故意的 深思熟虑的 仔细考虑
delicate	巧妙的 优雅的 精致的 微妙的
delicious	美味可口的 芬芳的 有趣味的 妙的
delight	欣喜 愉快 嗜好 使喜悦
deliver	救出 投递
delivery	投递 送交 交付 交货 分娩
demand	要求 需要
democracy	民主政治 民主国家
democratic	民主政体的 民主作风的 民众的
demonstrate	论证 说明 表示感情 演示 示威
dense	密集的 稠密的 烟、雾等浓密的
density	密度 稠密度
dental	牙齿的 牙科的
deny	否认 拒绝给予
depart	离开 出发 火车等开行
department	部 部门 系
departure	离开 出发
depend	,取决于 靠 依赖 信任
dependent	依靠的 从属的
deposit	存放 储蓄 使沉淀 放下 存款
depress	使沮丧 使低沉 降低 压低 使萧条
depression	抑郁 沮丧 萧条期 洼地 低压地区
depth	深度 深厚
deputy	代理人 代表 副…
derive	起源 得自
descend	下来 下降
describe	描绘 描写 形容 把…说成
description	描写 描述 说明书 作图
desert	沙漠 不毛之地 离弃 擅离 开小差
deserve	应受到 值得
design	设计 计划 图纸 设计 构思 图案
desirable	称心如意的 值得向往的
desire	愿望, 欲望 要求
desk	书桌 服务台
despair	绝望
desperate	不顾一切的 绝望的
despite	不管 尽管 不论
dessert	甜食 点心
destination	目的地
destroy	毁坏 毁灭 消灭
destruction	毁坏 消灭
detail	细节 详情 枝节 详述 详细说明
detect	察觉 发现 侦察
detection	察觉 发觉 侦察 探测
detective	侦察用的 侦探
determination	决心 决定 测定 诉讼的终止
determine	决定 决心 测定 确定
develop	使发达 开发 研制 使显影 发育
development	发展 新事物 开发 研制
device	设计 手段 谋略 诡计 装置 设备
devil	魔鬼
devise	设计 发明
devote	把…奉献给 致力于
diagram	图解 图表
dial	钟表等的针盘 刻度盘 拨电话号码
dialect	方言
dialog	问答 对话
dialogue	问答 对话
diameter	直径
diamond	钻石 金刚石 菱形 纸牌红方块
diary	日记簿 日记
dictate	使听写 口授 口述
dictation	口授笔录 听写
dictionary	词典 字典
die	死 死亡 草木枯萎 凋谢 渴望
diet	饮食 食物 规定饮食 使节食
differ	不同 意见不同
difference	差异 差别 争论 不和
different	不同的 各种的
difficult	困难的 艰难的 难应付的 难满足的
difficulty	困难 难事 困境
dig	挖 探究 捅 发掘的地点或遗迹
digest	文摘 摘要 消化 吸收 领会
digital	数字的
dim	昏暗 模糊不清的 使暗淡
dimension	尺寸 维度 面积 体积
dinner	正餐 宴会
dip	浸 泡 浸 沉落 浏览
diplomatic	外交的 外交工作的
direct	直接的地 指示 导演
direction	方向 方位 指导 指挥 用法说明
directly	直接地 马上
director	指导者 董事 校长 指挥 导演
dirt	尘 土 污物 下流话 脏话
dirty	脏的 手段等卑鄙的 下流的 弄脏
disappear	消失 不见 消亡 失踪
disappoint	使失望 使计划等落空
disaster	灾难 灾祸
disc	圆盘 唱片 磁盘 圆面 盘状软骨
discard	抛弃 扔掉
discharge	排出 放出 允许…离开 释放 放电
discipline	纪律 训练 学科 训练 惩罚
discount	折扣 对…打折 认为…不足轻重
discourage	使泄气 劝阻
discover	发现 看出 暴露 显示
discovery	发现
discuss	讨论 商议 议论 详述
discussion	讨论 议论
disease	疾病
disguise	假装 化装服 假装 扮作 隐瞒
disgust	讨厌 使讨厌 使恶心
dish	碟 盘 菜肴 一道菜
disk	圆盘 唱片 磁盘
dislike	不喜欢 不喜欢 厌恶
dismiss	解雇 解散 解散
disorder	混乱 杂乱 骚动 疾病 使紊乱
display	显示 表现 陈列 展览
disposal	配置 布置 排列 处置 处理
dispose	配置 布置 处理 处置 支配 除掉
dispute	争论 争吵
dissolve	使溶解 融化 解放 取消 使衰弱
distance	距离
distant	在远处的 久远的
distinct	不同的 明显的 清楚的
distinction	差别 不同 区分 辨别 清晰度
distinguish	区别 分清 表现突出 显出特色
distress	苦恼 痛苦 不舒适 不幸 使悲痛
distribute	分配 分发 分送 分布
distribution	分发 分配 散布 分布
district	区 地区 行政区
disturb	搅乱 打扰 使不安
ditch	沟 渠道 在…上开沟 摆脱 抛弃
dive	跳水 潜水 俯冲 低级夜总会 跳水
diverse	不同的 多种多样的
divide	划分 分开 分配 分裂 除
division	分 分开 分配 隔开 部门
divorce	离婚 分离 脱离
do	构成疑、否句 做 学习 做
doctor	医生 博士
document	公文 文件 文档
dog	狗 雄兽 尾随 跟踪
doll	玩偶 玩具娃娃 把…打扮得花技招展
dollar	美元 元
domestic	国内的 家庭的 家用的 驯养的
dominant	支配的 统治的 占优势的
dominate	支配 统治 高出于 居支配地位
donation	捐赠 赠送 捐赠物 捐款
donkey	驴 笨蛋
door	门 入口
dorm	宿舍
dormitory	集体宿舍
dose	药的剂量 一服 给药 给…服药
dot	点 小数点 打点于 好缀 敲打
double	两倍的 双人的 使加倍
doubt	怀疑 不一定 未肯定 怀疑 不相信
doubtful	怀疑的 可疑的 难料的
down	向下 沿着…往下 向下方的
downstairs	在楼下 楼下的
downtown	往或在城镇中心区闹市区的
downward	向下的 下行的
dozen	一打 十二个
draft	草稿 草图 汇票 起草 草拟
drag	拖 拉 拖 缓慢地移动 故意拖延
dragon	龙
drain	排水 使流出 排水管 水沟 消耗
drama	戏剧 剧本
dramatic	戏剧的 引人注目的 给人留下深刻印象的
draught	 气流,草稿,汇票,牵引,拉,通风
draw	画 抽取 汲取 拉 平局 图画 绘画
drawer	抽屉
drawing	图画 素描
dream	梦 梦想 做梦 幻想
dress	穿衣 打扮 衣服 女装
drift	漂流 意见 堆积物 冲洗 使漂流
drill	钻 钻孔 操练
drink	饮料 酒 饮料 喝 喝酒
drip	滴下 漏水 水滴
drive	驾驶 用车送 驾驶 驾驶 驱动器
driver	驾驶员 司机
drop	滴 下降 微量 落差 使滴下 下降
drown	淹死 淹没
drug	药品 麻醉品 毒品 用药麻醉
drum	鼓声 鼓状物 鼓膜
drunk	酒醉的
dry	干的 口渴的 干巴巴的 使变干
duck	鸭 鸭肉
due	预定的 应得的 应有的 到期的
dull	枯燥的 迟钝的 天气等阴郁的
dumb	哑的 沉默的 笨的
dump	倾倒 向国外市场倾销 垃圾场
durable	耐久的 持久的
duration	持续 持久 期间
during	在…的期间
dusk	黄昏
dust	尘土 去掉灰土
duty	职责 义务 税 关税
dye	颜料 染料 染 染色
dynamic	有生气的 能活动的 有力的 动力的
each	各自的 每 每个 各自
eager	热切的 渴望的
eagle	鹰
ear	耳朵 耳状物 听力 听觉
early	早 在初期 最早 早期的 早熟的
earn	挣得 获得
earnest	认真的
earth	地球 土地 陆地 土 泥
earthquake	地震
ease	容易 安逸 安心 缓和 减轻
east	东 东方 在东方 向东方
eastern	东方的 东部的
easy	容易的 舒适的 安逸的
eat	吃
echo	回声 回响 共鸣
economic	经济学的 经济上的
economical	节省的 经济学的
economy	经济 节约
edge	边 边缘 刀口 刃
edit	编辑
edition	版 版本
editor	编者 编辑
editorial	社论
educate	教育 培养 训练
education	教育 培养
effect	结果 效果 影响 产生 招致
effective	有效的 卓有成效的
efficiency	有效的 生效的
efficient	有效率的 生效的
effort	努力 尝试
egg	蛋 卵 鸡蛋
eight	八个
eighteen	十八
eighth	第八
eighty	八十
either	两者中任一的 任一个 也不
either...or	或者…或者 不是…就是
elaborate	精细的 详尽的
elastic	弹性的 灵活的 易顺应的 橡皮圈
elbow	肘 用肘推 挤进
elder	年龄较大的 年长的 长者 较大者
elderly	上了年纪的 垂老的
elect	选举 选择 侯选的
election	选举
electric	电的 带电的 电动的 刺激的
electrical	与电有关的 电气的 用电的
electricity	电
electron	电子
electronic	电子学的
elegant	优雅的 优美的 精致的
element	成分 要素 元素
elementary	初等的 基本的 容易回答的
elephant	大象
elevator	电梯 升降机美语
eleven	十一
eliminate	消灭 除去 排出
else	其它的 另外的
elsewhere	在别处 到别处
e-mail	电子邮件
email	电子信箱
embarrass	使窘迫 使为难
embassy	大使馆
embrace	拥抱 包含
emerge	出现 浮出 问题冒出 事实暴露
emergency	紧急情况 突发事件
emit	散发 发射
emotion	感情 情绪 激动
emotional	感情的 情绪的 情绪化的
emperor	皇帝
emphasis	加强语气 强调 重点
emphasise	加强…的语气 强调 着重
emphasize	加强…的语气 强调 着重
empire	帝国
employ	使用 雇用
employee	雇员 受雇者
employer	雇用者 雇主
employment	工作 雇用 使用
empty	空的 空洞的 空虚的 倒空 空箱
enable	使能够用
enclose	围住 封入 附上
encounter	遭遇到 偶遇 遭遇
encourage	鼓励 激励 支持
end	端 末梢 目标 结束 终止 结束
ending	结尾 结局
endless	无止境的 无穷的 没完没了的
endure	忍耐, 忍受
enemy	敌人 敌军 仇人 危害物
energy	活力 精力 能力 能 能量
enforce	实施 执行 强制 强迫 加强 坚持
engage	使从事于 占用时间 从事
engine	发动机 引擎 火车头
engineer	工程师 技师 船上的轮机手
engineering	工程学
enhance	提高 增强
enjoy	享受…之乐 欣赏 享有
enlarge	扩大 扩展 扩充 放大
enormous	巨大的 庞大的
enough	充足的地 足够的地 足够
enquire	询问
enquiry	询问
ensure	保证 担保 确保
enter	进入 加入 参加
enterprise	企事业单位 事业心 进取心 冒险精神
entertain	使感兴趣 招待 持有意见 见解等
entertainment	招待 款待 娱乐 表演节目
enthusiasm	热情 热心 积极性
entire	全部的 完整的
entitle	给书、文章等题名 给予…以权利
entrance	进入 入口 门口 入场 入会 入学
entry	进入 入口 通道 登记
envelope	信封
environment	环境
envy	妒忌 羡慕
episode	插曲 片段
equal	相等的 胜任的 同辈 比得上
equality	同等 平等 等式
equation	方程式
equip	装备 配备
equipment	设备 器材
equivalent	相等的 等价的 同等物 等价物
era	纪元 时代 年代
erect	直立的 笔直的 使竖立 树立
error	错误 谬误
escape	逃跑 逃跑 逃脱 被…忘掉 逃避
especially	特别 尤其 格外
essay	小品文 随笔 文章
essential	根本的 必要的 本质 要点
establish	建立 设立 确定 使确认 安顿
establishment	创建 制定 设施 公司
estate	房地产 地产 个人财产 遗产 阶层
estimate	估计 评价 判断
evaluate	评价 评估
eve	节日的前夜 前夕
even	甚至 更加 平坦的 对等的 偶数的
evening	晚上 傍晚
event	事件 大事
eventually	终于 最后
ever	总是 在任何时候 究竟
every	每 每个 每隔…的
everybody	每个人 人人
everyday	每天的 日常的
everyone	每个人 大家
everything	一切事 每件事
everywhere	处处 无论何处
evidence	根据 证据 迹象
evident	明显的 明白的
evidently	明显地 显而易见
evil	邪恶 罪恶 邪恶的 罪恶的
evolution	进化 演化
evolve	使发展 使进化
exact	确切的 精确的
exaggerate	夸张 夸大
exam	考试 检查
examination	考试 测试 检查 检验
examine	检查 对…考查考试 调查
example	例子 例证 范例 榜样
exceed	超过限度 范围 比…大 胜过
exceedingly	过份地
excellent	优秀的 杰出的
except	除…之外 把…除外 不计
exception	例外 除外
excess	超越 超过 超额量 过量的 额外的
excessive	过多的 过分的 极度的
exchange	兑换 调换 交换
excite	使激动 激发
excitement	激动 兴奋状态
exciting	令人兴奋的 使人激动的
exclaim	大叫 呼喊 大声叫
exclude	把…除外 排斥
exclusive	独家新闻 排外的 专有的 独占的
excursion	远足 集体游览 短途旅行
excuse	原谅 免除某人的责任 借口 理由
execute	处决 实施 执行
executive	实行的 行政部门 行政官
exercise	练习 锻炼 实施 锻炼 练习 锻炼
exert	尽力 发挥 施加
exhaust	用尽 气体等排出 排气 用不完的
exhibit	显示 呈现 展示 陈列 展品 呈现
exhibition	展览 展览会品
exist	存在 生存
existence	存在 生存
exit	出口 安全门 演员退场 退出 退出
expand	扩大 展开 扩张
expansion	伸展 扩张 膨胀
expect	期待 预期 盼望 认为 指望 希望?
expectation	期待 期望
expense	花费 费用
expensive	昂贵的 奢侈的
experience	经验 阅历 经历 体验 体验 感受
experiment	试验 实验 ,,做实验
experimental	实验上的 经验上的
expert	专家 能手 熟练的 内行的
explain	解释 说明 可作解释的事物
explanation	解释 说明
explode	使爆炸 爆发 爆炸
exploit	剥削 开拓 开发 利用
explore	勘探 探险 调查
explosion	爆炸 爆发 激增
explosive	爆炸性的 炸药 易爆炸物
export	出口商品 出口 输出 出口 输出
expose	使暴露 使面临 使感光 使曝光 揭露
exposure	暴露 面临 揭露 揭发 曝光
express	表示 表达 快递业务 快车
expression	表达 表示 表现 措辞 词句 表情
extend	延伸 延长 扩充 给予 伸出 伸展
extension	伸展部分 延伸部分 电话的分机
extensive	广泛的 广阔的 广大的
extent	范围 广度 范围
exterior	外部的 外在的 表面的
external	外部的 外面的 外部 外面
extra	额外的 特别地 额外的事物
extraordinary	异常的 非凡的
extreme	极端的 尽头的 极端 两极端
eye	眼睛 眼力 鉴赏力
eyesight	视力
fabric	编织物 结构 组织
face	脸 外观 器具的使用面 票面 面对
facility	便利 设备 熟练 灵巧 方便
fact	事实 真相 事情
factor	因素
factory	工厂
faculty	能力 才能 学科 系 院系全体教职工
fade	褪色 逐渐消失
fail	失败 衰退 使失望 使不及格
failure	失败 失灵 故障 失败的人或事 没做到
faint	微弱的 微小的 暗淡的 晕倒 昏厥
fair	定期集市 交易会 公平的 晴朗的
fairly	相当地 公正地
fairy	妖精 仙女
faith	信任 信念 信仰 忠实
faithful	忠实的 如实的
fall	落下 秋季 瀑布 落下 下降 倒
false	不正确的 假的 伪造的 虚伪的
fame	名誉 声望
familiar	熟悉的 熟知的
family	家 家庭 家族 氏族 尤指动植物的系
famine	饥荒
famous	著名的
fan	扇子 风扇 爱好者 扇 成扇形展开
fancy	想象力 爱好 别致的 想象 想要
fantastic	奇异的 怪诞的 异想天开的
fantasy	想象 幻想 想象的产物
far	远的 久远的 遥远的 远 到…程度
fare	车费 票价 食物 过活 生活 进展
farewell	再会 告别 欢送会
farm	农场 农庄 饲养场 耕种 种地
farmer	农夫 农场主
farther	更远地 更远的
fascinating	迷人的
fashion	时尚 时装 风格 式样
fashionable	流行的 时髦的
fast	快的 坚固的 紧紧地 禁食 斋戒
fasten	使固定 系牢 绑紧 扣紧
fat	脂肪 肥胖的 脂肪多的
fatal	致命的
fate	命运 结局 结果 将来 前景
father	父亲 创始人 F神父 上帝
fatigue	疲劳 疲乏
fault	过失 缺点 故障
faulty	有错误的 不完善的
favor	好感 赞成 恩惠 喜爱 支持
favorable	有利的 赞同的 满意的
favorite	最喜爱的 最喜爱的人或物
favour	赞赏 偏袒 恩惠 偏爱 赞同
favourable	有利的 赞同的 满意的
favourite	心爱的 特别受人喜欢的人物
fax	传真
fear	恐惧 害怕 担心
fearful	可怕的 担心的
feasible	可行的 可能的
feather	羽毛
feature	特征 特色 五官之一 报纸的特写
february	二月
federal	联邦的
fee	酬金 费如学费、手续费等
feed	喂养 吃饲料 动物、婴儿的一餐
feedback	反馈 反应
feel	触 摸 认为 以为 摸索 觉得
feeling	感情 感觉 知觉
fellow	人 家伙 同伴 同事 同伴的 同类的
female	雌性的 女性的 女子 雌性的动物
fence	栅栏 击剑 用栅栏…围起来 击剑
fertile	肥沃的 能繁殖的
fertilizer	化肥
festival	节日 音乐节
fetch	拿来 找来
fever	发烧 热病 狂热 使发烧 使发狂
few	很少的 几乎没有的
fiber	纤维 纤维质 质地 结构
fibre	纤维 光纤
fiction	小说 虚构、杜撰
field	田野 运动场 领域
fierce	狂暴的 凶猛的 残酷的 巨大的 强烈的
fifteen	十五
fifth	第五 五分之一
fifty	五十
fight	战斗 斗争 战斗力 打仗 斗争 争论
figure	扮演角色 认为 数字 外形 人物
file	档案 计算机文件 把…归档
fill	使充满 占据 补缺
film	影片 胶卷 薄层 把…拍成电影
filter	滤纸 过滤器 过滤
final	最后的 决定性的 决赛
finally	最后 终于 不可更改地 完全地
finance	财政 金融 为…提供资金
financial	财政的 金融的
find	找到 发展 达到
finding	发现物 常用复数研究结果
fine	美好的 纤细的 罚款 罚…的款
finger	手指 指状物
finish	完成 磨光 终了 最后阶段 完成
fire	火 射击 解雇 着火 射击
fireman	消防队员
firm	结实的 坚定的 商行 公司
first	第一 最初的 最初 一级品?
fish	鱼 钓鱼 捕鱼
fisherman	渔夫
fist	拳 拳头
fit	适当的 健康的 使适合 安装 病发作
five	五个
fix	使固定 安排 修理 准备食物等
flag	旗帜
flame	火焰 热情 发火焰 燃烧 感情爆发
flash	闪光 简短的新闻电讯 闪光 飞驰
flat	平的 单调的 一套房间 完全地
flavor	味道 风味 给…调味
flavour	给…调味
flee	逃走 消散 逃离 逃避
fleet	舰队 港湾 小河
flesh	肉 果子肉 肉体 肌肤
flexible	易弯曲的 灵活的
flight	飞行 航班 一段楼梯 逃跑
float	漂浮物 储备金 使漂浮
flock	兽群 鸟群
flood	洪水 淹没 灌溉 泛滥 大量涌到
floor	地板 楼层 发言权 在…上铺地板
flour	面粉
flourish	繁荣 兴旺 挥舞 挥动 炫耀 挥舞
flow	流 流量速 涨潮 泛滥洪水 流动
flower	花 精华 精粹 精英 盛时 开花
fluent	流利的 流畅的
fluid	液体 流体 流动的 易变的 流体的
fly	苍蝇 飞行 飞 乘飞机 驾驶飞机
focus	使聚焦 使集中 焦点
fog	雾气 雾 以雾笼罩 被雾笼罩
fold	折叠 褶痕 折页 折叠处
folk	人们 民间的
follow	跟随 沿着…前进 跟随 紧接
following	接着的 下列的 下列 下述
fond	喜欢的
food	食物
fool	蠢人 愚弄
foolish	愚蠢的 可笑的
foot	足 底部 英尺
football	足球比赛
footstep	脚步声
for	为了 给 代替 向 支持 因为?
forbid	禁止 阻止
force	力量、气 压力 军队 强制
forecast	预测 预报 预测 预报
forehead	前额
foreign	对外的 无关的 外来的 非…的本性的
foreigner	外国人
forest	森林
forever	永远
forge	打铁等 锻造 伪造
forget	遗忘 忘却 忘掉 编造谎言 忘记
forgive	原谅 免除债务等
fork	叉 分岔
form	形式 类型 格式 形成
formal	正式的 规格化的 礼仪上的
format	样式 书刊的版式 为书刊安排版式
formation	组织 形成物 构成 地岩层
former	以前的 在前的
formula	公式 配方 外方 规则 一定的做法
forth	向前 以后
fortnight	两星期
fortunate	幸运的
fortunately	幸运地 幸亏
fortune	命运 运气 财产
forty	四十
forward	向前的 进步的 向前 促进 转交
found	奠定…基础 创办
foundation	建设 基础 基金会
fountain	喷泉
four	四个
fourteen	十四个
fox	狐狸 狡猾的人
fraction	微量 碎片 分数
fragment	碎屑 片断
frame	构架 骨架 身躯 骨骼 门、窗框
framework	支架 框架 基本结构
frank	直率的
free	自由的 免费的 ,使自由"
freedom	自由
freeze	使结冰 冻结存款、工资、物价等
freight	货运费 运输 装货于
frequency	屡次 频繁 频率 周率 发生次数
frequent	频繁的 时常发生的 常见的 经常的
fresh	新的 新鲜的 水淡的 清新的 另外的
friday	星期五
fridge	= 冰箱
friend	朋友 友人 支持者 同情者
friendly	友善的 友谊的
friendship	友谊 友情 友好
frighten	使惊吓 吓唬 惊恐 害怕
frog	蛙
from	从…起 由于 因为 离 从 由
front	正面 前面的
frontier	国境 边境 边疆 尖端 新领域
frost	冰冻 严寒 霜 结霜 使结霜 下霜
frown	皱眉头
fruit	水果 果实 成果 结果
fruitful	多产的 有成效的
frustrate	破坏 阻挠 使失败 使泄气
fry	油煎 油炸
fuel	燃料 养料 给…加燃料 刺激 推动
fulfil	履行诺言等 完成计划等 达到
fulfill	履行诺言、责任等 完成 达到
full	全部 充分 正好 满的 完全的
fun	娱乐 乐趣 嬉戏 顽皮 有趣的人或事物
function	功能 职务 函数 机器运行
fund	资金 存款 物质资源的储备
fundamental	基本的 根本的 重要的 基本原则
funeral	葬礼的
funny	滑稽的 好笑的 古怪的 稀奇的
fur	软毛 皮毛 皮衣
furnace	火炉 熔炉
furnish	提供 供应 装备 布置
furniture	家具 器具 装置 设备
further	更远地 而且 另外的 更远的
furthermore	而且 此外
fuss	大惊小怪 小题大作 忙乱
future	未来 前途 远景
gain	获得 钟表走快 受益 增加 收益
gallery	长廊 画廊 矿坑中的地下坑道
gallon	加仑液量单位
game	游戏 比赛项目 运动会
gang	一群 一伙
gaol	= 监狱 使…坐牢
gap	缺口 裂口 间隔 空白 差距
garage	车库 常兼汽车修理、销售业务的加油站
garbage	垃圾 废料
garden	花园 庭园 从事园艺活动
gardener	花匠 园艺工
garlic	大蒜
gas	煤气 可燃气 气体 汽油
gasoline	= 美语汽油
gate	大门 阀门 闸门
gather	集合 聚集 采集 收集 逐渐增加 推测
gay	快乐的 鲜艳的 同性恋的 同性恋者
gaze	凝视 注视
gear	齿轮 传动装置 用具 装备 开动
gene	基因 遗传因子
general	总的 普遍的 首席的 将军 上将
generally	通常地 普遍地 大体上
generate	使发生 产生光、热、电等 引起
generation	一代人 发生 产生 生育
generator	发电器 发电机
generous	慷慨的 大方的 丰富的
genius	天才 天赋 有天才的人
gentle	温柔的 文雅的 柔和的 高尚的
gentleman	有身份的 先生 绅士
genuine	真实的 真正的 真心的 真诚的
geography	地理学
geometry	 几何学
germ	微生物 细菌
gesture	手势 姿态 表示 做手势
get	获得 使得 感染疾病 到达
ghost	鬼 鬼魂 幽灵
giant	巨人 巨大生物 巨人般的 巨大的
gift	赠品 礼物 天赋 才能
girl	少女 女孩 姑娘
give	给予 传递消息 发布命令 赠送
given	考虑到 特定的 规定的
glad	高兴的 情愿的
glance	扫视 匆匆一看 一瞥 扫视
glass	玻璃 玻璃杯 眼镜 玻璃制品
glimpse	一瞥 一看 瞥见
global	地球的 全球的 环球的 全局的
globe	地球 地球仪 球形物体
glorious	辉煌的 壮丽的 光荣的
glory	光荣 荣誉 壮丽 壮观
glove	手套
glow	发白热光 身体发热 白热光 激情
glue	胶 胶水 用胶水粘合
go	离开 变成 运行 被放置 流通
goal	目标 目的地 球门 进球得分
goat	山羊
god	神 上帝
gold	黄金 金币 金的 金制的 金色的
golden	金色的 黄金的 金制的 极好的
golf	高尔夫球
good	好的 善行 利益
goodby(e)	再见
goodness	善良 仁慈 美德 善行 天哪
goose	鹅
govern	统治 治理 支配 决定
government	政府 管理 支配
governor	州长 总督 统治者 主管 理事
grab	强夺 摄取 抓取
grace	优美 雅致 风度 魅力
graceful	优美的 优雅的 得体的 适度的
grade	等级 成绩 给…分等级 给…评分
gradual	逐渐的 逐步的
graduate	大学毕业生 研究生 毕业 授予学位
grain	谷物 谷类 颗粒 细粒
gram	克
grammar	语法书
gramme	克
grand	重大的 雄伟的 庄重的 豪华的
grandfather	祖父 外祖父
grandmother	外祖母
grant	拨款 准许 准许 授予 同意
grape	葡萄
graph	曲线图 图表
grasp	抓紧 抓牢 领会 理解
grass	草 草地
grateful	感激的 感谢的 令人愉快的
gratitude	感激 感谢
grave	严重的 严肃的 庄严的 墓穴 坟墓
gravity	地心引力 重力 庄重 严肃 严重
gray	灰色的
great	伟大的 重要的 巨大的 十足的
greedy	"贪吃的 贪婪的 ,,渴望的
green	绿色的 幼稚的 绿色 草地
greenhouse	温室
greet	欢迎 迎接
greeting	问候 招呼
grey	灰色的
grind	磨 碾碎
grip	牢牢抓紧 强烈吸引 抓紧 掌握 控制
grocer	食品 杂货商
gross	总的 毛重的 粗俗的 唐突的 过肥的
ground	地面 场地 理由 根据
group	组 类 集合 配合 把…分类
grow	生长 发展 变得 种花、庄稼等
growth	生长 发育 增加 扩大
guarantee	保修期 保证人或物 保证 担保
guard	保卫 守卫 看守 防护装置
guess	猜测 想 认为 猜测 推测 猜想
guest	客人 特邀演员 客串演员 旅客 宿客
guidance	帮助 指导 控制 遥控 导航
guide	指南 导游 给…领路 指导
guideline	指南 方针
guilty	有罪的 内疚的
guitar	吉它 六弦琴
gulf	海湾 隔阂 鸿沟
gum	口香糖
gun	枪 炮
guy	男人 家伙
gym	体育馆 健身房
gymnasium	体育馆 健身房
habit	习惯 习性
hair	头发 毛发
half	一半地的
hall	门厅 过道 礼堂 会堂 办公大楼
halt	停住 停止
ham	火腿 无线电收发报业余爱好者
hammer	锤子 钢琴等的音锤 敲 锤打
hand	手 指针 工具等的把手 交 递 给
handbag	女用手提包 旅行用手提包
handful	一把 少量 少数人
handkerchief	手帕
handle	触 处理 搬 操纵 柄 把手
handsome	男子漂亮的 女子端庄的 慷慨的
handwriting	书写 笔迹
handy	方便的 附近的 手巧的 寻巧的
hang	悬挂 绞死 风干 贴墙纸
happen	偶然发生 碰巧 不巧
happy	幸福的 快乐的 合适的
harbor	港口 海港
harbour	港口 避乱所 窝藏 怀有
hard	坚硬的 辛苦的 努力地
harden	使变硬 使变得坚强
hardly	几乎不
hardship	艰难 困苦
hardware	硬件 金属制品
harm	损害 危害 伤害 危害
harmony	协调 融洽 声谐调 和声学
harness	治理 利用
harsh	粗糙的 严厉的 刺耳目的
harvest	收割 收获 收成 收割 收获
haste	匆忙 赶快 赶紧 赶快
hat	帽子
hate	恨 不愿 憎恨 厌恶 憎恨 讨厌
hatred	憎恶 憎恨 怨恨
have	有 得到 吃 从事 享有 允许 雇用
hay	干草
hazard	危险 危害 冒险 使冒危险
he	他
head	头 领导 顶部 当…的首领 开往
headache	头痛
heading	标题
headline	大字标题 新闻提要
headmaster	中小学的校长
headquarters	司令部 指挥部 总部
heal	特别指创伤治愈 伤口愈合
health	健康状况
healthy	健康的 健壮的 有益健康的
heap	一堆 许多 使成堆 堆起
hear	听见 得知 倾听 审讯 听证
hearing	听 听力 审讯
heart	心 心脏 内心 要点
heat	热量 体温 热烈 使变热 加热
heave	用力地举起 抛
heaven	天堂 天国 天 天空
heavy	重的 大量的 沉闷地
hedge	树篱 防护物 用树篱围住 避免回答
heel	脚后跟
height	高 高度 高处 高地 顶点
helicopter	直升飞机
hell	地狱 苦境
hello	招呼用语喂 哟表示惊讶 问候声
help	求助 帮手 佣人 援助 避免
helpful	给人以帮助的 有益的
helpless	无助的 孤立无援的 无效的
hen	母鸡 雌禽
hence	今后 因此
her	[的宾格所有格]她的
herd	牛群 兽群
here	在这里 在这一点上 这时
hero	男主角 男主人公 英雄
heroic	英雄的 英勇的
hers	[的物主代词]她的所有物
herself	她自己 她本人
hesitate	犹豫 踌躇
hi	[表示问候或引起注意]喂 嘿
hide	把…藏起来 躲藏 遮掩 隐瞒 兽皮
high	高的 在高处的 高级的 高尚的 高
highlight	使显著 强调 最重要的部分
highly	高度地 很 非常
highway	公路 大路
hill	小山 山岗 丘陵 坡路 斜路
him	[的宾格]他
himself	他自己 他本人
hint	暗示 小许 指示 提示 暗示
hip	臀部
hire	租用 雇用
his	[的所有格物主代词]他的所有物
historic	历史上著名的 有历史意义的
historical	历史的
history	历史 来历 过去事件的记载或叙述
hit	击中 打中 碰撞 达到
hobby	兴趣 嗜好
hold	拿 包含 占有 船舱 控制 抓住
hole	洞 孔眼
holiday	假日 休息日 假期
hollow	空的 空洞的 虚伪的 掏空 洞 坑
holy	神圣的 圣洁的 至善的
home	家庭 发源地 家庭的 在家 回家
homework	家庭作业
honest	诚实的 正直的 老实的 公正的
honey	蜜 蜂蜜 家人 宝贝
honor	荣誉 敬意 H-阁下 使增光 尊敬
honorable	光荣的 可尊敬的 尊敬的
honour	荣誉 敬意 H-阁下 使增光 尊敬
honourable	可敬的 光荣的
hook	钩 夹子 钩住
hope	希望 期望 希望 所希望的人或事
hopeful	怀有希望的 抱有希望的
hopeless	绝望的 没有希望的 无用的
horizon	地平线 眼界 见识
horizontal	水平的 地平线的
horn	角 触角 号角 喇叭 角状物 警报器
horrible	可怕的 恐怖的 讨厌的 糟透的
horror	恐怖 战栗 讨厌的人
horse	马
horsepower	马力
hospital	医院
host	主人 许多 作…的主人或节目主持人
hostile	不友好的 怀有敌意的 敌方的
hot	热的 炎热的 辣的 急躁的 热衷的
hotel	旅馆, 饭店 酒店
hour	钟点 整点 小时 一个钟头 时刻
house	房屋 机构 H-议院 给…提供住处
household	家庭 户 家庭务的 家常的 普通的
housewife	家庭主妇
housework	家务 家事
housing	住房 住房供给 外、阀壳 防护罩
how	如何 怎样 多少 多么
however	然而 可是 不过 不管怎样
huge	庞大的 巨大的
human	人 人的 人类的 有人性的 通人情的
humble	谦卑的 卑贱的 降低身份 贬抑
humor	幽默感 诙谐
humorous	幽默的 诙谐的
humour	幽默 诙谐
hundred	百 一百
hunger	饥饿 渴望
hungry	饥饿的 渴望的
hunt	打猎 打猎 寻找 搜索
hurry	使加快 仓促, 匆忙
hurt	伤害 弄伤 伤害感情 伤痛
husband	丈夫
hut	小屋 棚屋
hydrogen	氢
i	我
ice	冰 冰冻甜食 冰冻 使成冰
ice-cream	 冰淇淋的,乳白色的
idea	主意 想法 概念 思想 计划 建议
ideal	理想的 完美的 空想的 观念的 理想
identical	相同的 同一的
identify	辨认出 鉴定 认为…等同于
identity	身份 本体 同一性质 相同处
idle	懒惰的 空闲的 无效的 无用的
if	如果 假如 是否
ignorance	无知 愚昧 不知道
ignorant	不知道的 无知的 愚昧的
ignore	忽视 不顾
ill	有病的 坏的 坏 不幸 祸害
illegal	不合法的 非法的
illness	病 疾病
illustrate	举例说明 阐明 加插图于
illustration	说明 例证 插图 举例说明
image	形象 映像 图象
imaginary	想像的 虚构的 假装的
imagination	想象力 空想 设想
imagine	想象 设想 料想
imitate	模仿 仿效 仿造 伪造
immediate	立即的 即刻的 最接近的 紧靠着的
immediately	直接地 立刻地 一…就
immense	巨大的 广大的
immigrant	移民 侨民 从外国移来的 移民的
impact	碰撞 冲击力 影响 效果
impatient	不耐烦的 急躁的 急切的
implement	工具 器具 贯彻 实现
implication	暗示 暗指 言外之意 牵连
imply	暗示 含有…的意义
import	进口 引进 进口 进口商品
importance	重要性
important	重要的 重大的 有权力的 有地位的
impose	把…强加于 加重…负担 征收税款
impossible	不可能的 办不到的
impress	给…以深刻印象 印 压印
impression	印象 感想 印次 印数
impressive	感人的 给人深刻印象的
improve	改进 改善 改善 变好
improvement	改进 改善 改进处
in	在…里 在…期间 在…之内
inch	英寸 少许 一点儿 慢慢地移动
incident	事件 事变
incline	使倾斜 使倾向于 倾向 倾斜
include	包括 包含 把…计算在内
income	收入 收益 所得
increase	增加 增大 增强
increasingly	日益地 愈加地
incredible	难以置信的 不能相信的
indeed	的确 ［表示惊讶］真的 真是
independence	独立 自主 自立
independent	独立的 自主的 不依赖…的
index	索引 指数 为…编索引
indicate	指点 指出 用手势、灯光等指示
indication	指示 表示 暗示 迹象
indifferent	冷漠的 平常的 不怎么好的
indirect	间接的 迂回的
indispensable	不可缺少的
individual	个别的 独特的 个人 个体
indoor	户内的 室内的
industrial	工业的 产业的 实业的
industrialise	使工业化
industrialize	使工业化
industry	工业 产业
inevitable	不可避免的 预期的 司空见惯的
infant	婴儿 幼儿 婴儿的 幼稚的 初期的
infect	传染 感染 影响…的心情 给…示影响
infer	推论 推断
inference	推论 推断 结论
inferior	下级的 下等的 质量等劣等的 次的
infinite	无限的 无穷的
inflation	膨胀 通货膨胀
influence	影响 权势 感应 影响 感化 左右
influential	有影响的 有权势的
inform	通知 告诉 告发
information	信息 数据 情报 资料 消息 通知
ingredient	混合物的组成部分 配料 成份 要素
inhabitant	居民
inherit	继承
initial	最初的 开始的 首字母
initiative	创始 决断能力 起始的 初步的
injection	注射 注入 注射液
injure	伤害感情等 损坏
injury	伤害 损害 受伤处
ink	墨水 油墨
inn	小旅店 客栈 小酒馆 小饭店
inner	内部的 里面的 内在的 秘密的
innocent	清白的 无罪的 幼稚的 没有恶意的
input	输入 向计算机输入的信息 输入
inquire	打听 调查 询问
inquiry	打听 询问 调查 查问
insect	昆虫
insert	插入 嵌入
inside	里面的 在内部 在…里面 内部
insight	洞察力 见识 深刻的了解
insist	坚持 坚决主张 坚持 坚决要求
inspect	检查 视察
inspire	使生灵感 鼓舞
install	安装 安置 任命 使就职
install	安装 安置 任命 使就职
installation	安装 安置 装置 设备 设施
instance	例子 事例 实例
instant	立即的 刻不容缓的 瞬间 倾刻
instead	代替 顶替
instinct	天性 本能 直觉
institute	学会 学院 研究所 建立 创立 制定
institution	创立 建立 惯例 制度 社会公共机构
instruct	教育 指示 通知
instruction	命令 指示 用法说明书 教育
instrument	仪器 器械 工具 乐器
insult	侮辱 辱骂
insurance	保险 保险费 保证
insure	给…保险 保证
integrate	使成为整体 合并
intellectual	知识分子 智力的 显示智力的
intelligence	智力 理解力 消息 情报
intelligent	聪明的 明智的 智能的
intend	想要 打算 计划
intense	强烈的 剧烈的 热心的
intensity	强度 强烈 剧烈
intensive	集中的 强化的 精细的 深入的
intention	意图 动机 目的
interaction	相互作用 相互影响
interest	兴趣 引起兴趣的事物 复数利益 利息
interesting	有趣的
interfere	干涉 介入 妨碍 干扰
interference	干涉 妨碍 电波等的干扰声
interior	内部的 内地的 内部
intermediate	中间的 中级的
internal	内部的 国内的 内服的
international	国际的 世界性的
internet	因特网
interpret	口译 解释为 解释 口译
interpretation	解释 阐明
interrupt	打断 打扰 中止 中断
interval	间隔时间 幕间休息
interview	接见 访问 面试 面谈 接见 会见
intimate	亲密的 详尽的 私人的
into	进入 到…里 成为 转为
introduce	介绍 引进 提出
introduction	介绍 引进 传入 绪论 导言
invade	侵略 入侵 涌入
invasion	侵略 侵犯
invent	创造 发明 虚构 捏造
invention	发明
invest	投资 投入 投资
investigate	调查 调查研究
investment	投资 投资额
invisible	看不见的 无形的
invitation	邀请 邀请书 请柬 鼓励 激起 引发
invite	邀请 招待 请求 征求 招致 吸引
involve	使卷入 使参与 牵涉 包含 包括
inward	里面的 内部的 内心的 向内
iron	铁 熨斗 熨 烫
island	岛 岛屿 岛国的
isolate	使孤立 隔离
issue	问题 争论点 发给 发表 发行
item	条款 项目 新闻等的一则
its	[的所有格]它的
itself	它自己 它本身
jacket	短大衣 夹克 马铃薯皮
jail	监狱 看守所
jam	果酱 堵塞 压紧 突然用力推
january	一月
jar	罐子 坛子 使受刺激 使震动
jaw	颚 颌 夹 喋喋不休 教训
jazz	爵士乐 爵士舞
jealous	 妒忌的 猜疑的
jeans	工装裤 牛仔裤
jet	喷射 喷射流 乘喷气式飞机旅行 喷射
jewel	宝石 宝石饰品
job	工作 职位 零活 一件工作 任务 职责
join	参加 联合 和…在一起
joint	接合处 关节 连接的 联合的
joke	笑话 开玩笑
journal	日报 期刊 杂志 日记 日志 分类帐
journalist	记者 新闻工作者
journey	旅行 旅途 旅行
joy	喜欢 欢乐 乐趣 趣事
judge	法官 裁判 鉴赏家 判断 裁决 审判
judgement	判决 审判 判断力 判断 看法
judgment	判断力 审判 判决 评价 意见
juice	蔬菜、水果等的汁 液 浆
july	七月
jump	跳 跳跃 跳过 暴涨 猛增
june	六月
jungle	丛林 密林
junior	年少的 职位较低的 晚辈 等级较低者
jury	陪审团
just	正义的 公正的 正好 只是 刚刚
justice	正义 司法 审判
justify	证明…是正当的 为…辩护
keen	渴望的 热心的 理解力强的 敏锐的
keep	保留 保持 遵守 饲养 管理
kettle	水壶
key	钥匙 键 关键 答案 关键的
keyboard	键盘 用键盘输入信息
kick	踢
kid	小孩 小伙子
kill	杀死 扼杀 毁灭
kilo	千
kilogram	千克 公斤
kilogramme	千克 公斤
kilometer	千米 公里
kilometre	千米 公里
kind	仁慈的 友好的 种类
kindergarten	幼儿园
kindness	仁慈 好意 友好行为
king	国王 君主
kingdom	王国 领域
kiss	吻 接吻
kitchen	厨房
kite	风筝
knee	膝 膝盖
kneel	跪下
knife	小刀 餐刀 用刀刺切
knock	敲 敲打 碰撞 敲 打 碰 撞击
knot	结 节 疤 打结 捆扎
know	知道 了解 会 懂 认识 熟悉
knowledge	知识 熟悉 了解
lab	= 实验室
label	标签 在…上贴标签 把…称为
labor	劳动 工人 劳动 费力地前进
laboratory	实验室
labour	劳动 劳动力 辛劳 劳动 苦干
lack	缺乏 缺少 短缺
lad	男孩 少年 小伙子
ladder	梯子 阶梯
lady	夫人 女士 女盥洗室
lag	落后 滞后 落后 走得慢
lake	湖 湖泊
lamb	小羊 羔羊 羔羊肉
lamp	灯
land	陆地 土地 国家 使…着陆 登陆
landlord	地主 房东
landscape	风景 景色 风景画 风景照片
lane	小路 小巷 车道 跑道
language	语言
lap	膝部 跑道的一圈
large	大的 大[只用于短语]
largely	大部分地 主要的 大规模地
laser	激光
last	最后的 最近的 最后地 持续
late	迟的 晚期的 最近的 迟 晚
lately	最近
later	更迟的 更后的 过后 以后
latter	后面的 末了的 后一半的 后者
laugh	大笑 笑声 笑 开玩笑的事物
laughter	笑 笑声
launch	使船下水 发射导弹 发射
laundry	洗衣店 洗好的衣服 洗涤
lavatory	盥洗室 厕所
law	法律 法规 法制 定律 规律
lawn	草地 草坪
lawyer	律师
lay	铺设 产卵 布置 世俗的 外行的
layer	层 层次
layout	布局 安排 设计
lazy	懒惰的 懒散的
lead	铅
leader	领袖 领导者
leadership	领导
leading	领导的 最重要的 首位的
leaf	叶子 张 页 薄金属片
league	同盟 联盟 协会 社团
leak	漏 泄露出去 漏洞 泄露
lean	倾斜 把…靠在 倚 靠
leap	跳 跃 跃过 跳跃 飞跃
learn	学习 学会 得知 获悉 记住
learned	博学的 有学识的
learning	学识 学问 学习
lease	租约 租契 出租 租得
least	最小的 最少的 最小少
leather	皮革
leave	离开 留下 遗留 离开 许可
lecture	演讲 告诫 向…发表演讲 讲课
left	左边的 向左 左边 政党左派
leg	腿部
legal	法律上的 合法的 法定的
legislation	立法 法规
leisure	空闲时间 闲暇 悠闲 安逸
lemon	柠檬 柠檬汁
lend	借书 借给 赊予
length	长度 一段 程度 范围 
lens	透镜 镜头
less	更小的地 较次劣的地
lesson	课业 功课 课程 教训 经验
lest	唯恐 免得
let	让 允许 设 使 出租
letter	字母 文字 信 函件
level	水平面 等级 平的 水平的
liable	?肌?有…倾向的 有偿付责任的
liberal	自由的 慷慨的 大量的 心胸宽大的
liberate	解放 释放
liberty	自由 释放 准许权 许可
librarian	图书馆馆长或管理员
library	图书馆 图书室 藏书
licence	许可 特许 许可证 执照 许可
license	许可 执照 准许
lick	舔
lid	盖子
lie	躺 平放 位于 说谎 谎话 假话
life	生命 生物 寿命 生活 生存
lifetime	一生 终生
lift	提升 尤指云、雾消散 举起 电梯
light	光 点燃 照亮 轻的 不费力的
lightning	闪电
like	相像的 像 和…一样 喜欢 希望
likely	可能的 可能
likewise	同样地 也
limb	肢 臂 翼
limit	限制 范围 限定 限制
limitation	限制 局限性
limited	有限的 限定的
line	线 电线 路线 使排成行
link	环 联系 连接 联系
lion	狮子
lip	嘴唇
liquid	液体 液体的 液态的
liquor	酒
list	目录 名单 表 列举 排列
listen	听 听信 听从
liter	升容量单位
literary	文学上的 文人的 从事写作的
literature	文学作品 文献 图书资料
litre	升
little	小的 不多的 几乎没有 毫不
live	活的 活生生的 实况转播的 燃烧着的
lively	活泼的 逼真的
liver	肝脏
living	活着的 现存的 生活 生计
load	装载量 负荷 负载 装 装载 装货
loaf	一条面包
loan	贷款 借出 借出
lobby	门厅 饭店等接待厅
local	地方的 局部的 当地居民
locate	把…设置在 探明
location	位置 场所
lock	锁 被锁上
lodge	供…以临时住宿 寄宿
log	原木 圆木 航海飞行日志
logic	逻辑学 逻辑性
logical	逻辑的 合乎逻辑的
lonely	孤独的 寂寞的 荒凉的 人迹稀少的
long	长的 长时间的 长期地 渴望
look	看 看起来 看 外表 脸色
loop	环 环状物 打圈
loose	松的 宽松的 释放 解开
loosen	使变松 松开 放松
lord	贵族 L-主 上帝 阁下
lorry	卡车 货运汽车
lose	失去 失败 损失 耽搁 浪费时间
loss	遗失 丧失 亏损 减少 失败 输掉
lot	许多 大量 签 抽签
loud	响亮的 大声的 喧闹的 大声地
love	爱好 热爱 热爱 喜爱 情人 零分
lovely	美丽的 可爱的 有趣的 令人愉快的
lover	爱好者 情人
low	卑鄙的 俗的 低速的 向下 低点
lower	较低的 下等的 放下 放低 降低
loyal	忠诚的
loyalty	忠诚 忠心
luck	运气 幸运 好运
lucky	幸运的 吉祥的 侥幸的
luggage	行李
lump	团 块 肿块 使成团块
lunch	午餐 便饭
lung	肺
luxury	奢侈品 豪华
machine	机器 机械
machinery	总称机械 机器 机构
mad	发疯的 恼火的 极愚蠢的 狂妄的
madam	对妇女的尊称女士 夫人
magazine	期刊 杂志 枪上的弹仓 弹盒
magic	魔力 魔术 有魔力的 不可思议的
magnet	磁体 磁铁
magnetic	磁性的 有吸引力的
magnificent	壮丽的 宏伟的
maid	女仆 未婚少女
mail	邮件 信件 邮寄
mailbox	邮筒 邮箱
main	主要的 最重要的 干线?
mainland	大陆 本土
maintain	维持 保养 赡养 供养
maintenance	维持 保持 保养 维修 坚持 主张
major	主要的 主修课程 主修 专攻…
majority	多数 大多数
make	做 使 致使 迫使 获得 等于 总计
male	男性的 雄性的
man	男人 人 人类
manage	管理 经营 设法做到、完成 处理
management	管理 经营 管理人员
manager	经理 管理人员
mankind	人类
manner	方式 方法 态度 礼貌 规矩
manual	手工的 体力的 手册 指南
manufacture	大量制造 杜撰 制造 制品
manufacturer	生产厂商 制造公司 厂主
many	许多的 多的 许多人或物 许多
map	图 地图
march	三月
march	三月
margin	页边 边缘 余地
marine	海的 航海的 水兵 船舶 海运业
mark	斑点 记号 弄污 标志 给试卷打分
market	市场 集市 销路 需求 销售
marriage	婚姻 婚姻生活 婚礼 密切结合
married	婚姻的 已结婚的
marry	同…结婚
marvellous	奇迹般的 惊人的
marvelous	奇异的 了不起的
marxist	马克思主义者
mask	面具 假面具 伪装 遮盖 掩饰
mass	大量 群众 群众的 大规模的
massive	巨大的 大量的 魁伟的
master	主人 能手 男教师 掌握 精通
mat	席子 垫子
match	火柴 比赛 对手 和…相配
mate	伙伴 配偶 使…配对
material	物质 材料 素材 资料 题材 物质的
math	数学
mathematical	数学上的
mathematics	数学
maths	数学
matter	物质 情况 麻烦事 要紧 有关系
mature	成熟的 理智的 慎重的 成熟
maximum	最大量 最高值 极限 最大限度的
may	五月
may	五月
maybe	可能 也许
mayor	市长
me	[I的宾格]我
meal	一餐 膳食
mean	表…的意思 意指 意为 意欲 意味着…
meaning	意义 意思 重要性 目的
means	方法 手段 收入 财富
meantime	其时 在此期间 同时 当时
meanwhile	当时 与此同时
measure	量度 措施 测量 有…长宽 高
measurement	测量 衡量 尺寸 大小
meat	肉
mechanic	技工 机械工人
mechanical	机械的
mechanism	机械装置 机构 结构
medal	奖章 勋章 纪念章
media	 媒体
medical	医学上的 医疗的 内科的
medicine	医学 医术 药
medium	中等的 媒介物 中间 适中
meet	遇到 会见 遭到 满足 聚会
meeting	聚会 会议
melt	使融化 使熔化 消散 消失
member	成员 会员
membership	成员资格 会员资格
memorial	纪念的 纪念碑 纪念物 纪念馆
memory	记忆 记忆力 回忆 怀念 存储器
mend	修理 修补 缝补 纠正 修补 补钉
mental	心智的 精神的 神经不正常的
mention	提到 谈到 提述 提及
menu	菜单
merchant	商人
mercy	怜悯 宽恕 仁慈
mere	仅仅的 纯粹的
merely	仅仅 只不过
merit	优点 功劳 价值 应得 值得
merry	愉快的 欢乐的
mess	混乱 混杂 脏乱
message	消息 启示 要旨 差使
metal	金属
meter	仪表 计 表 米 公尺
method	方法 办法
metre	公尺 米
metric	公制的 米制的
microphone	麦克风 扩音器
microscope	显微镜
midday	正午 中午
middle	中间 中等物 中间的 中等的
midnight	午夜 子夜
might	的过去式 可能 请 应该
mild	温和的 酒、烟等味淡的 适度的
mile	英里
military	军用的 军事的
milk	牛奶 植物流出的白色乳液 挤奶
mill	磨坊 面粉厂 工厂 车间
millimeter	毫米
millimetre	毫米
million	百万 百万个 无数
mind	头脑 记忆 注意 想法 注意 介意
mine	[I的物主代词]我的 矿山 开矿
mineral	矿物的
minimum	最低限度 最小量 最低的 最小的
minister	部长 大臣 牧师
ministry	政府的部
minor	较小的 不严重的 未成年人
minority	少数 少数民族
minus	减的 负的 减去 减号 负号
minute	分 分钟 一会儿 片刻 细微的
miracle	奇迹
mirror	镜子 反映 反射
miserable	悲惨的 可怜的 令人难受的
mislead	使误入岐途
miss	M-小姐 错过 未赶上 惦念 想念
missile	导弹
missing	失踪的 欠缺的 不在的
mission	使命 任务 代表团
mist	薄雾 眼睛的模糊不清
mistake	错误 误解 弄错
mister	先生 M- 放在姓氏前…先生
misunderstand	误解 误会 曲解
mix	混合 调制 相混合 混合物
mixture	混合 混合物
mobile	活动的 流动的
mode	方式 样式 时尚 时兴
model	模型 模范 模特儿 式样 型号
moderate	中等的 温和的 使缓和 变缓和
modern	现代的 现代化的
modest	谦虚的 客气的 适度的
modify	修改 变更 缓和 减轻
moist	潮湿的 微湿的
moisture	湿气 潮湿
mold	模子 模型 铸模 造型 浇涛
molecule	分子
moment	片刻 瞬间 某一个特定时刻
monday	星期一
money	货币 财富 金钱
monitor	监听器 学校的班长 监听 监视
monkey	猴子
month	月 月份
monthly	每月的 按月计算的 每月一次 月刊
monument	纪念碑 遗迹
mood	情绪 心境 心境不佳
moon	月球 月亮 月光 卫星
moral	道德上的 道德 伦理 寓意
more	更多的 另外的 更多数量 更 另外
moreover	而且
morning	早晨 上午
mosquito	蚊子
most	最多的 大部分的 最大量 最
mostly	主要地 基本上
mother	母亲 妈妈
motion	物体运动 提议 手势 打手势示意
motivate	激励 鼓励 作为…的动机 促动
motive	动机 目的 作品的主题
motor	马达 电动机 汽车 机动的 汽车的
mould	模子 模型 铸模 造型 浇铸
mount	增长 登上 扶上马车 …山峰
mountain	山 高山 山脉 大量
mouse	老鼠 胆小怕事的人 鼠标
mouth	嘴巴 口 出入口
move	移动 感动 提议 移动 走棋 步骤
movement	运动 迁移 移动 乐章
movie	影片 电影院
much	许多的 许多 很 几乎 大概
mud	泥 泥浆
mug	有柄的大杯
multiple	多样的 多重的 倍数
multiply	使增加 使繁殖 乘 增加 繁殖
murder	谋杀 谋杀罪 谋杀 屠杀 破坏
muscle	肌肉 体力 力量
museum	博物馆
mushroom	蘑菇
music	音乐 乐曲
musical	音乐的 悦耳的 音乐喜剧
musician	音乐家 乐师 作曲家
must	必须 很可能 一定要 必须做的事
mutual	相互间的 共同的
my	[I的所有格]我的
myself	[反身代词]我自己 我亲自
mysterious	神秘的 难理解的
mystery	神秘的事 神秘小说故事等 神秘
myth	神话
nail	指甲 爪 钉 钉 使牢固
naked	裸体的 裸露的 无掩饰的 未遮盖的
name	名字 名声 知名人士 列举 任命
namely	即 也就是
narrow	窄的 有限的 目光短浅的 使变窄
nation	国家 民族
national	国民 全国性的 国内的 民族的
nationality	国籍 民族
native	出生地的 本土的 本地人 本国人
natural	自然界的 正常的 天赋的
naturally	当然 自然地 天然地 天生地
nature	自然界 天性 特性 人体的本能
naval	海军的 军舰的 船的
navigation	航行 航海 航空
navy	海军
near	近的 亲密的 接近 靠近
nearby	附近的 在附近
nearly	几乎 差不多
neat	整洁的 简洁的 优美的 纯净的
necessarily	一定 必定
necessary	必须的 必然的 必需品
necessity	需要 必然性 必需品
neck	脖子 颈
need	必须 需要 必须 贫困 需要
needle	针 指针
negative	否定的 消极的 负的 否定词 底片
neglect	疏忽 忽视 忽略
negotiate	谈判 成功越过 谈判 协商
negro	黑人 黑人的
neighbor	邻居 邻近 邻接
neighborhood	近邻 街坊 附近地区
neighbour	邻居 邻国 邻近 邻接
neighbourhood	邻近 附近地方 地段 四邻
neither	两者都不 两者中无一
nephew	侄儿 外甥
nerve	神经 勇气
nervous	神经的 神经紧张的
nest	巢 筑巢
net	网状物 罗网 用网去捕 净的 纯的
network	网状组织 网状系统 广播电视网
neutral	中立的 中性的 公平的 中立者
never	从不 永不 决不 从来没有
nevertheless	然而 不过 仍然 不过
new	新的 没经验的 重新开始的 新发现的
news	新闻
newspaper	报纸
next	其次 下一个 靠近 下一个
nice	美好的 正派的 令人高兴的 细微的
niece	侄女 外甥女
night	夜晚 黑暗 黑夜
nightmare	恶梦 恐怖的经历 可怕的事件
nine	九
nineteen	十九
ninety	九十
ninth	第九
nitrogen	氮
no	不 并不 毫不 并非 不许 不
noble	高尚的 贵族的 贵族
nobody	谁也不 小人物 无足轻重的人物
nod	点头 表示同意 打瞌睡
noise	噪声 喧闹声
noisy	嘈杂的 喧闹的
none	没有一个 无一 一点也不
nonsense	废话 胡说 愚蠢的行为 胡说 废话
noodle	 常用复数面条
noon	中午 正午
nor	也不 也没有
normal	正常的 标准的 精神健全的
normally	正常地 正常情况下
north	北 北方 北的 向北方
northeast	东北 东北的 在东北的 向东北
northern	北部的 来自北方的 向北的
northwest	西北 西北的 在西北的 向西北
nose	鼻子 闻出 探出 嗅 闻
not	不 不是 不会
note	笔记 注释 便条 纸币 名望 记下
notebook	笔记本
nothing	什么也没有 微不足道的人或事
notice	通知 注意 注意到
noticeable	显而易见的 显著的 值得注意的
notify	通知 报告
notion	概念 想法 打算 意图
noun	名词
novel	新奇的 长篇小说
november	十一月
now	现在 立刻 现在 既然
nowadays	现今 现在
nowhere	任何地方都不
nuclear	原子核的 核心的 中心的
nucleus	原子核 核心 中心
nuisance	讨厌的东西
number	数量 号码 给…编号码 总计
numerous	为数众多的 许多
nurse	护士 保姆 护理 照料 养育 喂养
nursery	托儿所 苗圃
nut	坚果 螺母
nylon	尼龙
obey	服从 遵守
object	物体 目的 对象 不赞成 反对
objection	反对 异议
objective	目标 宗旨 客观的 外界的 真实的
obligation	义务 职责 恩惠
oblige	迫使 施恩于 使感激
observation	观察 注意 观察力 评论 意见
observe	观察 遵守 评说 注意 说 评论
observer	观察者 观察员 评述者
obstacle	障碍 妨碍
obtain	获得 得到
obvious	显然的 明显的
occasion	重要的场合 时机 机会
occasional	偶然的 特殊场合的
occupation	职业 工作 占用 占领 消遣
occupy	占用 占领 使忙碌
occur	出现 发生 想到
occurrence	发生 事件 出现
ocean	海洋 无限 无际
o'clock	 点钟,钟头
october	十月
odd	古怪的 奇数的 临时的 有零头的
of	…的 属于…的 在…之中
off	脱离的 离去 从…离开
offence	过错 冒犯 引起反感的东西
offend	冒犯  触怒 使不悦
offense	犯罪 冒犯 进攻 讨厌的东西
offensive	攻击的 进攻性的 攻势 进攻
offer	提出的价格 提供 出现 祭献
office	办公室 服务处 官职
officer	官员 办事员 军官
official	官方的 官员的 官员 高级职员
often	经常 常常
oil	油 食油 石油 给…涂上油
okay	对 好 可以 同意 许可
old	年老的 …岁的 长时间的 过去的
omit	省略 删去 忽略 忘记
on	连接上 在…上 靠近 向前 继续
once	一次 曾经 一…就… 一次
one	一个 一个人 一个的 某一…的
oneself	自己 自身 亲自 本身
onion	洋葱
only	仅仅 唯一的 最好的 可是
onto	到…上 在…上
open	开的 开阔的 营业的 开始 开放
opening	最初 空地 洞 孔 通道 职位的空缺
opera	歌剧
operate	操作 使运转 起作用 动手术
operation	运转 操作 手术 运算 作用
operational	操作的 动作的
operator	操作员 总机接线员 外科手术员
opinion	意见 看法 主张 舆论 专家鉴定
opponent	对手 敌手 反对者
opportunity	机会 时机
oppose	反对 反抗
opposite	对面的 对立面 在…的对面
optical	光学的 视觉的 视力的
optimistic	乐观的 乐观主义的
option	选择 选择权 供选择的事物
optional	可以任选的 非强制的
or	或 或者 不然 否则 或者说 即
oral	口头的 口语的 口部的
orange	橙的 橙色的 橙色 橙树
orbit	轨道 眼窝 环绕轨道动行
orchestra	交响管弦乐队
order	次序 正常状况 秩序 命令 命令
orderly	整齐的 有条理的
ordinary	普通的 平常的 平凡的
ore	矿石 矿砂
organ	器官 风琴 机构 喉舌
organic	有机物的 有机体的 器官的
organisation	组织 安排 团体 有机体
organise	组织 安排 筹办
organism	生物 有机体
organization	组织 安排 团体 有机体
organize	组织 安排 筹办
origin	起源 开端 出身 血统
original	原型 原作品 最初的 新颖的 原版的
other	其他的 别的 其他的人或事
otherwise	否则 在其它方面 另外 否则
ounce	盎司 英两 少量
our	[的所有格]我们的
ours	[的物主代词]我们的
ourselves	[反身代词]我们自己 我们亲自
out	在外 彻底地 明显的 通过
outcome	结果 后果 成果
outdoor	户外的 露天的 野外的
outer	外部的 外层的
outlet	出口 出路 通风口
outline	轮廓 提纲 画出轮廓 概括
outlook	景色 风光 观点 见解 前景 前途
output	产量 产品 输出功率 输出信号 排泄量
outset	开端 开始
outside	外面的 在外面 在…外
outstanding	杰出的 显著的
outward	外面的 公开的 向外的 向外 外形
oval	卵形的 椭圆形的 卵形 椭圆形
oven	烤箱 炉灶
over	在…上面 跨越 结束 越过
overall	综合的 全面的 工装裤 工作服
overcoat	外衣 大衣
overcome	战胜 压倒
overhead	在头顶上的 悬空的 间接开支
overlook	眺望 俯瞰 忽略 漏掉 宽容
overnight	通宵的 一夜的
overseas	到国外的 到海外去的
overtake	赶上 超过 突然降临于
owe	欠…的钱 把…归功于 应感谢 欠钱
owing	欠着的 应给予的
own	拥有 自己的
owner	所有人 物主
ownership	所有权 所有制
ox	牛 公牛
oxygen	氧, 氧气
pace	步子 速度 踱步于… 用步子量
pack	背包 大量 捆扎 包装
package	包裹 包装用品 打包 包装
packet	小包裹 小捆
pad	垫 衬垫 加衬垫 填塞
page	页 张
pain	疼痛 精神上的痛苦 努力 辛苦
painful	疼的 痛苦的 费力的 费心的
paint	绘 描绘 绘画作品 油漆 颜料
painter	油漆匠 画家
painting	绘画 油画
pair	一对 一双 夫妇 使成双 使配对
palace	宫殿 华丽大厦
pale	苍白的 灰白的 淡的 暗淡的
palm	手掌 手心 棕榈树
pan	平底锅
panel	专门问题小组 面 仪表盘 嵌板
panic	惊慌 恐慌的 使恐慌
pants	裤子
paper	纸 报纸 文章 考卷 票据
parade	游行 检阅
paragraph	段 节 报刊的短讯
parallel	与…平行的 类似的 平行线
parcel	包裹 打包
pardon	原谅 饶恕 赦免
parent	父亲 母亲 动植物的母体 起源
park	公园 停车场 停放车辆
parliament	议会 国会
part	部分 职责 分 断绝关系 分开
partial	部分的 有偏心的 偏爱的
participate	参加
particle	粒子 微粒 极小量
particular	特别的 挑剔的 细节
particularly	特别 尤其
partly	部分地 在一定程度上
partner	合作者 配偶
party	社交聚会 党 政党 一组 一伙人
pass	经过 通过  考试及格 通行证 关口
passage	通道 文章的段落 节
passenger	乘客 旅客
passion	爱情 激情 大怒 激怒
passive	被动的 消极的
passport	护照
past	越过 经过 过去 过去的
paste	糊 浆糊 粘 贴
pat	轻轻拍打 轻拍 轻打
patch	补钉 补块 斑片 碎片 缝补 修补
path	小路 小径 路线 轨道 路程
patience	耐心
patient	有耐心的 能忍受的 病人
pattern	图案 形式 模范 仿制 模仿
pause	暂停 暂停
paw	爪
pay	支付 缴纳 付清 给予 薪水 工钱
payment	支付 偿付的款项 报应
pea	豌豆
peace	和平 宁静 和好 治安
peaceful	和平的 安宁的 和平时期
peach	桃树
peak	山顶 最高点 最高的 高峰的
pear	梨树
peasant	农民 没受教育的人 乡巴佬
peculiar	特有的 特别的 奇怪的
peer	偷看 窥探 同辈 伙伴
pen	钢笔 蘸水笔
penalty	罚 惩罚 刑罚 罚款
pencil	铅笔
penetrate	穿透 渗入 看穿
penny	便士
pension	抚恤金 养老金 津贴
people	人们 人民 民族
pepper	胡椒 辣椒
per	每 经 由 靠
perceive	认识到 觉察出 理解 领悟
percent	百分之…
percentage	百分数 百分率 比例 部分
perception	感觉 觉察力
perfect	完美的 极好的 完全的 使完美
perform	履行 完成 做 演出 表演
performance	履行 完成 演出 表演
perhaps	也许 大概 可能
period	一段时间 时期 学时 课时 周期 句点
permanent	永久的 持久的
permission	同意 许可 允许
permit	允许 许可证 执照
persist	坚持 不屈不挠
person	人 身体 人称
personal	个人的 私人的 身体的 亲自的
personality	人格 个性 名人 人物
personnel	全体人员 人事部门
perspective	远景 前途 视角 透视图 透视画法
persuade	说服 劝服
pessimistic	悲观的 悲观主义的 厌世的
pet	宠物 宠儿
petrol	汽油
petroleum	石油
phase	阶段 方面 相位 使分段进行
phenomenon	现象
philosopher	哲学家 哲人
philosophy	哲学
phone	电话机 受话器 耳机 打电话
photo	= 照片
photograph	照片
phrase	短语 习惯用语
physical	身体的 物质的 物理的 自然界的
physician	内科医生
physicist	物理学家
physics	物理学
piano	钢琴
pick	镐 挑选 采 摘 剔除
picnic	野餐 郊游 去野餐
picture	画 图画 照片 图像 画面 影片
pie	馅饼
piece	块 片 段 一件 一张 拼凑 拼合
pierce	刺穿 看穿 洞察
pig	猪
pigeon	鸽子
pile	堆 叠 大量 堆 堆积 拥挤进入
pill	药丸
pillar	柱 支柱 栋梁
pillow	枕头
pilot	飞机驾驶员 领航员 驾驶飞机等
pin	别针 胸针 用别针别住
pinch	捏 拧 夹痛 拧 困苦 经济困难
pine	松树
pink	粉红色 粉红色的
pint	品脱流量单位
pioneer	先驱 倡导者 开拓者
pipe	管子 烟斗 管乐器
pit	坑 深渊 陷井 煤矿
pitch	沥青 球场 音高 程度 投 定调
pity	怜悯 同情 遗憾的事 可怜 同情
place	地方 名次 地位 寓所 放置
plain	平原 旷野 明白的 朴素的
plan	计划 打算 平面图 计划 打算 设计
plane	飞机 平面 水准 水平
planet	行星
plant	植物 作物 工厂 种植
plantation	种植园 大农场
plastic	塑料 塑料制品 塑料的
plate	盘子 钢板 镀上 电镀
platform	讲台 站台 平台 政纲 党纲
play	游戏 剧本 比赛 游戏 演奏 扮演
playground	操场 游乐场
pleasant	令人愉快的 合意的 举止文雅的
please	请 使高兴 满意 喜欢 想要
pleasure	愉快 满足 乐趣 乐事
pledge	誓约 保证物 发誓 抵押
plentiful	富裕的 丰富的
plenty	丰富 充足
plot	情节 阴谋 密谋 标出 密谋
plough	= 犁 犁 费力地前进
plow	犁 犁 耕
plug	塞子 插头 堵 塞住
plunge	使投入 使陷入 投入 跳水
plural	复数的
plus	加上 正的 附加的 加号
pocket	钱袋 袖珍的 把…装入袋内
poem	诗
poet	诗人
poetry	诗歌 诗集
point	尖 点 条款 分数 指向 表明
poison	毒物 毒药 毒害 使中毒 有毒的
poisonous	有毒的 有害的 恶毒的 有恶意的
pole	柱 杆 地极 磁极 电极
police	警察 加警方 警察局
policeman	警察
policy	政策 方针 保险单
polish	上光蜡 磨光 擦亮
polite	有礼貌的 客气的 有教养的 文雅的
political	政治的
politician	政治家 政客
politics	政治 政治学
poll	选举 民意测验 请…投票
pollute	弄脏 污染 使…堕落
pollution	污染
pond	池塘
pool	水池 把…集中在一起
poor	贫穷的 比平时预计少 可怜的 粗劣的
pop	流行的 通俗的 流行音乐
popular	大众喜爱的 大众化的 普及的
population	人口 全体 总数 人口的聚居
pork	猪肉
port	港口
portable	轻便的 手提式的
porter	搬运工人
portion	部分 一份
portrait	肖像 画像 描绘
pose	摆好姿势 提出问题 姿势
position	位置 职位 姿势 情况 看法 地位
positive	确实的 肯定的 正的 阳性的
possess	拥有 具有 支配 控制 保持
possession	所有 占有 占有物 财产
possibility	可能 可能性 可能的事
possible	可能的 合理的 接受的 适应的
possibly	也许 或许 可能
post	邮政 柱 岗位 公布 投寄
postage	邮资
postcard	明信片
poster	招贴 海报
postman	邮递员
postpone	推迟
pot	罐 壶 盆
potato	马铃薯
potential	潜在的 可能的 潜在的可能 潜力
pound	镑 英镑
pour	灌 倒 注 流出 蜂拥
poverty	贫穷 贫困
powder	粉末 火药 炸药
power	力 功率 影响力 能力 权力
powerful	强有力的 有权力的 作用大的
practical	实践的 实用的 实际的 实用主义的
practically	几乎 简直 实际上
practice	实习 习惯 实践 实行实践 实行
practise	练习 实行 练习 开业
praise	表扬 称赞 表扬 赞扬
pray	祈祷 渴望 祈求
prayer	祈祷 祷告 祈文
precaution	预防 警惕 谨慎
preceding	在前的 前面的
precious	珍贵的 贵重的
precise	精确的 准确的
precision	精确 精密 精确的
predict	预言 预告 预测
preface	序言 引言 前言
prefer	更喜欢 宁愿
preferable	更可取的 更好的
preference	偏爱 优惠 选择权 优先权
pregnant	怀孕的 充满的 意味深长的
prejudice	偏见 成见
preliminary	初步的 预备措施
preparation	准备 预备 安排 筹备 制剂
prepare	准备 预备
preposition	介词
prescribe	医生开处方 规定
presence	出席 到场 存在
present	出席的 现在 礼物 赠送 提出 上演
presentation	介绍 陈述 呈现 表现形式
presently	不久 一会儿 现在 目前
preserve	保存 保藏 ??维护 腌渍
president	总统 总裁 校长 会长
press	压 按 紧握 挤 报界 压榨机
pressure	压力 强制 气压
presumably	推测上 大概
pretend	假装 自命 自称 假装 装作
pretty	漂亮的 秀丽的 相当 颇
prevail	胜过 获胜 流行 普遍
prevent	预防 防止
previous	先 以前的 在…之前
price	价格 代价 标价 定价
pride	骄傲 自豪 自尊心 以…为自豪
priest	教士 教父
primarily	主要地 首先
primary	首要的 主要的 基本的 初级的 最初的
prime	主要的 最好的 鼎盛时期 青壮年时期
primitive	原始的 早期的 简单的 粗糙的
prince	王子 小国的君主
princess	公主 王妃
principal	主要的 重要的 校长 资本 本金
principle	原则 原理 道义 信念
print	印 印刷 出版 印痕 印刷 图片
prior	优先的 在前的 在…之前
priority	先 前 优先 优先考虑的事物 优先权
prison	监狱
prisoner	囚犯 俘虏
private	私人的 个人的 秘密的 私下的
privilege	优惠 特许 特权 给予…特权 特免
prize	奖赏 奖金 珍视 珍惜 得奖的
probable	很可能的 大概会的 有希望的
probably	大概 或许 很可能
problem	问题 疑难问题 须认真对付的困难
procedure	程序 手续 过程 步骤
proceed	继续前进 继续做某事 开始进行
process	过程 工序 诉讼 加工 处理
procession	队伍 行列
produce	生产 制造 拿出 产品 农产品
product	产品 产物 乘积 成果 作品
production	生产 制造 生产量 产品 作品
profession	专业 职业 表白
professional	职业的 专业的 职业选手
professor	教授
profile	剖面 外形 人物简介 画…侧面像简介
profit	利润 盈利 利益 益处 从…得益
program	电脑程序 节目单 计划 编制程序
programme	程序 计划 节目单 为…编程序
progress	前进 进展 进步 发展
progressive	前进的 进步的 进步人士
prohibit	禁止 阻止
project	方案 工程 投掷 放映 设计
prominent	凸起的 显著的 杰出的
promise	允诺 答应 有指望 允诺 诺言 希望
promote	提升 提拔 发起 举办 宣传 促成
prompt	促使 激励 迅速的 准时地
pronoun	代词
pronounce	发音 宣布
pronunciation	发音 发音方法
proof	证据 证明 校样 防…的 耐…的
proper	适当的 正当的 符合体统的 本身的
property	财产 资产 财产权 所有权 特性
proportion	比例 比重 部分 均衡 相称
proportional	比例的 均衡的
proposal	建议 求婚
propose	建议 打算 求婚
prospect	前景 前途 景色 境界 预期
prosperity	兴旺 繁荣
prosperous	繁荣的 兴旺的
protect	??保卫
protection	??
protective	保卫的 ?さ?爱护至备的
protein	蛋白质
protest	抗议 反对
proud	骄傲的 自大的 自豪的 使人自豪的
prove	证明 证实 证明是 表明是
provide	提供 供给 规定
provided	以…为条件 假如
province	省 学术领域 活动范围
provision	准备 预备 提供 供应 条款 规定
provoke	引起 惹怒 煽动行动
psychological	心理上的 心理学的
pub	小酒吧 小旅馆
public	公共的 公开的 知名的 公众 民众
publication	出版 发行 出版物 发表 公布
publicity	众所周知 闻名 宣传 广告
publish	出版 刊印 公布 发表
pull	拖 拉 拔 采 拉伤 拉 拖 拉绳
pulse	脉搏 脉冲 博动 跳动
pump	泵 抽水机 打气筒 用泵抽水
punch	猛击 冲压 穿孔 冲压机 穿孔机
punctual	准时的 正点的 守时的
punish	惩罚 狠狠地对付 痛击
pupil	学生 小学生 眼睛的瞳孔
purchase	购买 购买 购买的物品
pure	纯粹的 纯净的 无邪的 完全的
purple	紫色的
purpose	目的 意图 意志 决心
purse	钱包
pursue	追赶 追求 继续 从事
push	推 推动 促使 催促 推 突袭
put	放 记下 表达 使…进入状态
puzzle	难题 谜 使迷惑 使困惑
qualification	资格 限定条件 合格证
qualify	使合格 对词义限制 修饰
quality	质量 品质 特性
quantity	数量 量 [常]大量 大宗
quarrel	争吵 吵架
quarter	四分之一 一刻钟 地区 住处
queen	女王 纸牌、国际象棋中的王后
question	问题 待解决的问题 疑问 询问
queue	队 列 排队
quick	快的 迅速的 敏捷的 伶俐的 性急的
quiet	安静的 宁静的 使安静 平静下来
quit	离开 退出 停止 放弃 离开 辞职
quite	完全 十分 相当地
quiz	小测验 猜谜或问答节目 进行测验
quotation	引语 语录
quote	引用 报价 引用 引证
rabbit	兔子
race	民族 比赛 全速前进 和…比速度
racial	种族的 人种的
rack	架 行李架
radar	雷达
radiation	辐射线能
radical	激进的 彻底的 数学根的 基本的
radio	收音机 无线电
rag	破布 破烂衣服 低劣的报纸
rage	大怒 发怒 指暴风雨等猛烈地进行
raid	袭击 突然搜查
rail	栏杆 围栏 铁轨 铁路
railroad	铁路
railway	铁路
rain	雨 雨天 下雨 使…如雨而下
rainbow	虹 彩虹
raincoat	雨衣
rainy	下雨的 多雨的
raise	抬起 举起 提出 发起 抚养 募集
rally	大会 集合 把…集合起来
range	范围 山脉 排列成行 并列 延伸
rank	军衔 等级 排 评级 列入
rapid	快的 迅速的
rare	罕见的 稀薄的 指肉半熟的
rarely	很少地
rat	老鼠
rate	比率 等级 价格 评级 列为
rather	有些 宁可 更确切地 相反地
ratio	比 比率 比例
rational	合理的 理性的
raw	生的 未加工的 未经训练的
ray	光线 射线
reach	到达 伸手 达到 伸出 区域
react	反应 起作用 有影响 反抗
reaction	反应 化学反应 反作用力 反动
read	阅读 看懂 明白
reader	读者 读物 读本
readily	容易地 乐意地 很快地
reading	阅读 读书 读物 选读 读数
ready	准备好的 乐意的 思想、表达等敏捷的
real	真的 现实的
realise	认识到 了解 实现
realistic	现实主义的
reality	实际存在的事物 现实
realize	认识到 了解 实现
really	真正地 确实地
realm	王国 领域 范围
rear	后方的 后部 马用后腿站立
reason	理由 理性：理智 论证 劝说 推理
reasonable	合情理的 通情达理的 价钱公道的
rebel	反抗 抵抗 反叛者
recall	回想 忆起 收回 召回
receipt	收据 收条 收到
receive	收到 接到 蒙受 受到 接见
receiver	受话器 接收机器 收到…的人
recent	最近的 近来的 近代的
recently	最近 近来
reception	接待室 招待会 接收效果
recession	商业萧条时期 不景气 退却 后退
reckon	考虑 认为 想 料想 计算
recognise	承认 认可 认出 识别
recognition	认出 识别 承认 公认 重视
recognize	识别 承认 公认
recommend	推荐 建议 使受欢迎 托付
recommendation	推荐信 介绍信 建议 劝告
record	记录 档案 记录 把声音等录下
recorder	录音机 记录器 记录者
recover	恢复 痊愈 收回 重新获得
recovery	恢复 痊愈 收回 复得
recreation	娱乐 消遣
recruit	征募新兵 补充 新兵 新成员
red	红的 红色的 红色 红色衣服
reduce	缩小 减少 简化
reduction	减少 缩减 数学约简
refer	提到 查阅 叫人去… 把…归因于
reference	参考 查阅 参考文献 介绍人 提及
refine	精炼 精制 提纯 使有教养 使文雅
reflect	反射光、热、声音、影像等 反响 反映
reflection	反射 反映 倒影 映像 思考
reflexion	映象 倒影 反射 沉思 熟虑
reform	改革 改造 重新组成 改革 改过
refresh	提神 振作 使清新
refrigerator	冰箱 冷藏室
refugee	政治上的避难者 难民
refusal	拒绝
refuse	拒绝 谢绝 废料 垃圾
regard	把…看作 注意 对待 注意 尊敬
regarding	关于
regardless	不管…的 不顾一切地 不管怎样
region	地区 区域 领域 范围
register	登记 挂号 登记 挂号邮寄
regret	后悔 遗憾 感到懊悔 懊悔
regular	定期的 有规律的 正规的 匀称的
regulate	管理 控制 调整 校准
regulation	调整 调节 规则 规定
reinforce	加强 加固 增援
reject	拒绝接受 抵制 驳回
relate	使有联系 叙述 讲 与…有关系
relation	家人 亲戚 关系 叙述 陈述
relationship	关系 亲属关系
relative	相对的 亲戚
relativity	相对论 相关性
relax	使放松 缓和 放宽 放松 松懈
release	释放 发行 发表 免除
relevant	相关的 切题的 中肯的 恰当的
reliable	可靠的 确实的
relief	痛苦、烦恼等的解除 救济 浮雕
relieve	减轻 免除 救济 救济 成浮雕
religion	宗教
religious	宗教的
reluctant	不愿意的 勉强的
rely	依靠
remain	停留 留下 保持 依然
remark	评论 意见 注意 说 注意 评论
remarkable	显著的 了不起的
remedy	疗法 药品 治疗 补救 纠正
remember	记起 牢记 记得 记起
remind	提醒 使想起
remote	遥远的 偏僻的
removal	拿走 搬走 除掉 撤职
remove	消除 去掉 搬走 运走 搬迁
render	使变得 给予 翻译 表演 演奏
renew	继续 重新开始 使更新 更换
rent	租金 租用 出租 出租
repair	修理 补救 修理 修补 维修状况
repeat	重说 重复 背诵 重述 重复 重播
repeatedly	反复地 再三地
repetition	重复 反复
replace	代替 把…放回原处 归还
replacement	替代 替代物
reply	回答 答复
report	报告 报道 汇报 报到 报告
reporter	记者 新闻广播员
represent	代表 象征 描绘 说明 声称
representative	代表 代表性的 代理的
reproduce	使再生 复制 生殖
republic	共和国 共和政体
republican	共和政体的 共和党人
reputation	名声 好名声 声望
request	请求 需要
require	要求 需求
requirement	要求 需求
rescue	救援
research	探讨 研究
resemble	类似 象
reservation	保留条件 预定
reserve	储备 预定 储备物 保留地 节制
reservoir	水库 蓄水池
residence	住处 住宅 居住居留 居住期间
resident	居民 住院医生 居住的 住宅的
resign	辞职 辞去 放弃 使顺从
resist	抵抗 反抗
resistance	阻力 抵抗 电阻
resistant	有抵抗力的
resolution	决议案 决心 决定
resolve	解决 决定 决议 分解 决心
resort	求助于 凭借 常去 常去之地 胜地
resource	资源 财源 机智 智谋
respect	尊敬 关心 方面 尊敬 考虑
respective	各自的
respectively	独自地 个别的 分别的
respond	回答 响应 反应
response	回答 回应 反应 反响
responsibility	责任 职责
responsible	应负责的 有责任心的
rest	剩余部分 其余的人
restaurant	餐馆 饭店
restless	不安宁的 焦虑的
restore	把…恢复原状 归还 交还
restrain	控制 抑制 阻止
restraint	抑制 克制 克制物
restrict	限制 约束
result	结果 答案 答数 起因于 导致
resume	摘要 简历
retail	零售 零售 零售的
retain	保留 保持 挡住 聘
retire	退休 退职 退下 离开 隐居 隐退
retreat	撤退 退却 安静的地方 撤退 退却
return	回去 还 归还 回报 回程的
reveal	显示 显露 泄露 揭发
revenue	税收
reverse	颠倒 倒转 使倒退 颠倒的
review	回顾 审视 复飞 评论 评论
revise	修订 修正 复习
revolt	起义 造反 厌恶 反感 反抗 造反
revolution	革命 大变革 旋转 周期 循环
revolutionary	革命的 大变革的 旋转的 革命者
reward	回报 报答 报酬 酬金 报答 酬谢
rhythm	节奏 韵律 有规律的循环运动
rib	肋骨
ribbon	条带 带子
rice	稻米 米饭
rich	富有的 丰富的 肥沃的 财富
rid	使摆脱 使排除
ride	乘车 骑马 乘 骑
ridge	山脊 鼻梁 分水岭
ridiculous	荒谬的 可笑的
rifle	步枪 来福枪
right	右边的 正确的 右 权利 对
rigid	僵硬的 刻板的 严格的
ring	电话 铃声 打电话 按铃
riot	骚乱 暴动 闹事 骚乱
ripe	成熟的
rise	升高 上涨 上升 上涨 起床
risk	冒风险
rival	竞争对手 竞争的 与…竞争
river	江 河
road	道路 途径
roar	吼叫 轰隆震响 呼喊声
roast	烘烤 烘烤的 一大块烤肉
rob	抢劫 非法剥夺 使丧失
robot	机器人
rock	岩石 摇摆 摇动 使震惊 摇动
rocket	火箭 由火箭推进的导弹 烟火
rod	棍 棒
role	角色 作用 任务
roll	卷 摇晃 使滚动 使摇摆 卷 名册
roller	滚筒 卷轴 压路机
romantic	罗曼蒂克的 多情的 不切实际的
roof	顶 房顶 屋脊
room	房间 空间 余地
root	根 根源 生根
rope	绳子 索 一串珠宝 吊刑 绞刑
rose	玫瑰 蔷薇 玫瑰色 玫瑰红
rotate	使旋转 使轮流 使循环
rotten	腐烂的 腐朽的 讨厌的 令人不快的
rough	表面粗糙的 粗野的 大致的 粗暴地
round	圆的 围着 在周围 使成圆形
rouse	唤醒 惊醒 激发起
route	路线 航程
routine	例行的 平淡的 例行公事
row	一排 划船 吵架 口角
royal	皇家的 王室的 盛大的 堂皇的
rub	擦 摩擦 擦亮 擦 磨
rubber	橡胶的 橡皮
rubbish	垃圾 废物 废话 胡说八道
rude	粗糙的 粗鲁的 猛烈的
rug	小地毯 毛毯
ruin	毁灭 使破产 毁灭 废墟
rule	统治 裁决 规则 习惯 支配
ruler	统治者 尺子 直尺
rumor	谣言 谣传 传说
rumour	谣言 传闻
run	跑 车辆行驶 跑过 赛跑
rural	农村的 乡村的
rush	赶忙 催促 冲 急忙 急流
rust	锈 生锈 脑子衰退
sack	袋 解雇 床 解雇 掠夺
sacrifice	牺牲品 祭祀 牺牲 祭祀 祭祀
sad	悲伤的 忧愁的
saddle	马、自行车等的鞍 给马等装鞍
safe	安全的 保险箱
safety	安全
sail	帆 风车翼板 航行 乘船旅行 启航
sailor	水手 海员
saint	圣人 略作S 用于人、地名前圣…
sake	缘故 理由
salad	色拉 凉拌菜
salary	薪金 工资
sale	出售 卖 贱卖 销售额
salesman	售货员
salt	盐 氯化钠 腌 加盐
same	相同的 同样的人或事
sample	样品 标本 抽样检查
sanction	认可 许可 支持 赞成 制裁 处罚
sand	沙 沙滩 尤指用沙纸磨光
sandwich	三明治 夹肉面包 夹入 挤进
satellite	卫星 人造卫星 卫星国
satisfaction	满足 满意
satisfactory	满意的 满足的
satisfy	满足 满意 符合
saturday	星期六
sauce	调味品 酱油
saucer	碟状物 茶碟
sausage	香肠 腊肠
save	拯救 储蓄 保留 节省 除了
saving	节省 节约 储蓄金 存款
saw	锯子 锯开
say	说 说明 发言 意见 发言权
scale	刻度 天平 攀登 按比例绘制
scan	浏览 扫描 浏览 扫描
scandal	丑闻 丑事
scarce	稀少的 不足的
scarcely	几乎不 刚刚
scare	惊恐 恐慌 惊吓 吓唬
scatter	驱散 散开 撒开
scene	风景 场景 戏一场
scenery	风景 景色
schedule	计划 时刻表 一览表 预定 制作…表
scheme	计划 方案 阴谋 计划 密谋
scholar	学者 持奖学金的人
scholarship	奖学金 学问 学识
school	学校 学派 上学 鱼等的群
science	科学 学科
scientific	科学的
scientist	科学家
scissors	剪子
scold	责骂 申斥
scope	范围 理解力范围 发展余地
score	记录 记号 分数 二十 记号
scout	侦察员 童子军 侦察 搜索
scrape	刮, 擦
scratch	搔 勾销 抓 搔 抓伤 擦伤
scream	尖叫 尖叫 引起捧腹大笑的人
screen	屏风 屏银幕 掩蔽 选拔
screw	螺丝 螺旋桨 拧紧 旋紧
script	剧本原稿 手稿 原稿 笔迹 手迹
sea	海 洋 大量
seal	封条 图章 密封 盖章于 海豹
search	搜 搜索 搜索 寻找
season	季节 当令期 旺季 加调味品
seat	座位 座席 使入座 使就座
second	第二 第二的 第二人物 秒 片刻
secondary	次要的 中级的 继发性的 第二期的
secret	秘密的 秘密 秘诀
secretary	秘书 书记 部长 大臣
section	节 段 部分 科室 截面 剖视图
sector	尤指商业或贸易部门 扇形面
secure	安全的 牢靠的 得到 使安全
security	安全
see	看 明白 经历 理解
seed	种子 根源 给…播种 结籽
seek	寻找 寻求 试图 力图 请求 要求
seem	似乎 好象
segment	部分 片 段 分割
seize	抢占 抓住 攻击 ,利用
seldom	很少
select	选择 挑选 选择的 精选的
selection	选择 精选的人或物
self	自己 本身 私心
selfish	自私的
sell	卖 出售 出卖 背叛 卖 销售
semester	学期
semiconductor	半导体
seminar	研究小组 研讨会 大学的研究班
senate	参议院 立法机构
senator	参议员 上议员
send	送 派遣 促使 寄信 派人
senior	年长的 资格老的 长辈 上级 上司
sense	意思 感觉 见识 意识 觉得
sensible	明理的 明智的
sensitive	敏感的 灵敏的 易怒的
sentence	句子 宣判 判决 宣判 判决
separate	使分开 区分 分离 不同的 单独的
september	九月
sequence	连续 系列 次序 顺序
series	系列 序列
serious	严肃的 严重的 认真的
servant	仆人 雇员
serve	服务 服役 招待 服役 任职
service	服务 服侍 服役 维修 保养
session	会议 一次开会或开庭 一段时间
set	放 调整 日、月等落下 凝结
setting	环境 背景 安装 装置
settle	解决 支付 定居 下沉
settlement	解决 移民 定居 清偿 结算
seven	七
seventeen	十七
seventy	七十
several	几个 若干
severe	严重的 严厉的 激烈的 困难的
sew	缝纫
sex	性别 性
sexual	性别的 性欲的 性的
shade	荫凉处 遮光物 遮避 色彩等渐变
shadow	阴影 暗处
shake	震动 颤抖 握手 摇动 震动 抖动
shall	将 会 必须
shallow	浅的 肤浅的 浅滩
shame	耻辱 羞愧 可耻的人或物 使羞愧
shape	形状 情况 使成形 塑造 实现
share	分享 分给 部分 股份 分担
sharp	锐利的 强烈的 敏锐的 正好 恰
shave	剃 刮 削 修面 刮脸 刮脸
she	她
shed	脱落 脱去 流泪、血 散发出
sheep	羊 绵羊
sheer	纯粹的 陡峭的 轻的 垂直地
sheet	张 片 页 被单
shelf	架子
shell	外壳 甲 炮弹
shelter	掩蔽处 掩蔽 ??庇护 躲避
shield	盾 护板 ??防护
shift	变换 转换 变速 转变 轮班
shine	发光 发亮 擦亮 光泽
ship	用船装运
shirt	衬衫
shiver	冷颤 颤抖
shock	震动 震惊 休克 电击 使震惊
shoe	鞋
shoot	射击 疾驰而过 发芽 发射,拍摄 嫩枝
shop	商店 工场 车间 购买
shore	岸 岸边 陆
short	短的 短暂的 矮的 低的 缺乏的
shortage	不足 短缺
shortcoming	缺点 短处
shortly	立即 不久 简洁地
shot	射击 投篮 炮弹 拍摄镜头
should	应该 将会 万一 竟然会
shoulder	肩 承担 肩负
shout	大声叫 喊 呼出 呼喊 叫
show	表演 展览物 出示 带领 显现
shower	下阵雨 冲淋浴 浇 倾注
shrink	萎缩 收缩 缩小 减少
shrug	耸肩
shut	关闭 闭上 停业
shy	害羞的 胆怯的
sick	生病的 恶心的 厌倦的 不耐烦的
side	旁边 方面 性质 站在…的一边
sideways	斜向一边的 侧身的
sigh	叹息 叹气
sight	视力 看见 情景 风景
sightseeing	观光 游览
sign	符号 标牌 征兆 签署
signal	信号 导致…的行动 发信号 通讯
signature	签名 签字
significance	意义 重要性
significant	有意义的 意味深长的 重要的 重大的
silence	寂静 沉默 无言 使沉默 使安静
silent	沉默的 无言的 安静的 不吵闹的
silk	丝 绸
silly	傻的 糊涂的
silver	银 银器 镀银
similar	类似的 相似的
similarly	相同地 同样地
simple	朴素的 简易的 纯真的 完全的
simplicity	简单 朴素 纯真 无知
simplify	简化
simply	仅仅 只 简直 完全 简单地 简易地
sin	罪孽 犯罪
since	自从…以来 既然 因为 后来
sincere	诚恳的 真诚的
sing	唱 歌唱 嗡嗡作响 鸣响 吟咏 歌颂
single	单一的 单人的 单程票
singular	单数 独特的 非凡的 单数的
sink	使下沉 降低 厨房中的洗涤槽
sir	先生 S-用于姓名前…爵士
sister	姐 妹
sit	坐下 使坐下
site	所在地 场所 使处于某处
situation	形势 情况 处境 境况 位置 场所
six	六
sixteen	十六
sixty	六十
size	大小 尺寸 尺码 量 额
skate	滑冰 滑冰 冰鞋
sketch	草图 概要 短剧 写生 概述
ski	滑雪板 滑橇 滑雪
skilful	灵巧的 熟练的
skill	技巧 技能 熟练
skilled	需要技能的 熟练的
skillful	灵巧的 熟练的
skim	浏览 快读 掠过 掠过 浏览
skin	皮肤 毛皮 外皮 去…的皮
skirt	裙子 边缘 郊区
sky	天 天空
slam	砰地关上 砰地放下
slap	耳光 掌击 打…一巴掌
slave	奴隶 做苦工 拼命地干
sleep	睡眠 睡觉
sleeve	袖子 衣袖 唱片封套
slender	细长的 苗条的 微薄的
slice	薄片 切片 把…切成薄片
slide	滑动 幻灯片 滑动 悄悄溜走
slight	轻微的 微小的 纤细的 脆弱的
slim	苗条的 微少的 不充实地
slip	滑倒 溜走 犯错误 失误 滑倒
slippery	滑溜的 狡猾的 不可靠的
slope	倾斜 斜坡
slow	慢的 缓慢的 迟钝的 使放慢
small	小的 少的
smart	整洁漂亮的 聪明的 机智的 敏捷的
smash	打碎 猛撞 粉碎 破碎声 撞击
smell	散发气味 闻到 察觉 闻 气味
smile	微笑 笑容 微笑 露出笑容
smoke	烟 吸烟 吸烟 吸烟 冒烟
smooth	平滑的 平稳的 温和的 使光滑
snake	蛇
snap	咬 折断 咬住 使突然折断
snow	雪 下雪 下雪 如雪一般地落下
so	那么 非常 也 不错 因而 所以
soak	浸湿 浸透
soap	肥皂
soar	高飞 翱翔 高涨 猛增
so-called	 所谓的,号称的
soccer	英式足球
social	社会的 社交的 交际的
socialism	社会主义
socialist	社会主义者 社会主义者的
society	社会 团体 协会 社交界 相伴
sock	短袜
soda	苏打 汽水
sofa	长沙发
soft	柔软的 温柔的 不含酒精的 光滑的
software	软件
soil	弄脏 泥土 土壤 变脏
solar	太阳的
soldier	士兵
sole	脚底 鞋底 唯一的 独占的 专有的
solemn	庄严的 严肃的 指承诺真诚的 正式的
solid	固体 固体的 实心的 稳固的
solution	解决办法 溶液 溶解
solve	解决
some	一些 有些 一些 大约 稍微
somebody	某人 有人 重要人物
somehow	设法 不知怎么地
someone	某人 有人
something	某事 某物 一些 几分
sometime	某时 近期内 曾经 一度
sometimes	有时 不时地
somewhat	有点儿 稍微
somewhere	某处
son	儿子
song	歌曲
soon	不久 早 快
sophisticated	老练的 复杂的 尖端的
sore	疼的 痛心的 痛处 疮口
sorrow	悲伤 忧愁
sorry	对不起的 抱歉的 遗憾的 难过的
sort	种类 排序 分类 整理
soul	心灵 灵魂 人 精华 中心人物
sound	声音 发声 听起来 健康的 正当的
soup	汤 羹
sour	酸的 脾气坏的 刻薄的
source	根泉 来源 出处
south	南方的 向自在南方
southeast	东南 东南地区的
southern	南部的 南方的
southwest	西南 西南地区的
sow	播种 散布 传播 播种
space	太空 宇宙 空间 把…分隔开
spacecraft	宇宙飞船
spade	铁铲 铁锹
span	一段时间 跨度
spare	备用的 多余的 节省 饶恕
spark	火花 火星 放火花 引发
speak	说话 讲话 演说 发言 说某种语言
speaker	演说者 发言者 讲某种语言的人
special	特别的 特别好的 特别的事或物
specialise	专攻 使…特殊化 专攻 专门研究
specialist	专家 专门医生
specialize	专攻 使…特殊化 专攻 专门研究
species	物种 种类
specific	特定的 特殊的 明确的 具体的
specifically	特别地 说得具体些
specify	指定 详细说明
specimen	样本 标本
spectacular	引人入胜的节目 壮观的 引人注目的
speculate	思考 推测 做投机买卖
speech	言语 讲话 演讲
speed	速度 快 迅速 急行 加速
spell	拼写
spelling	拼写 拼法
spend	花费钱等 消磨 花费 耗尽
sphere	球体 活动范围 研究领域
spider	蜘蛛
spill	使溢出来
spin	编织 杜撰 使旋转 结网 吐丝
spirit	精神 精灵 情绪 酒精
spiritual	精神上的 宗教上的
spit	吐唾沫痰 吐出 唾液 吐痰
spite	恶意 怨恨
splendid	壮丽的 辉煌的 好极了的
split	使分裂 分开 分裂的 裂口
spoil	损坏 宠坏 食物等变坏 掠夺物
spokesman	发言人
sponsor	发起 主办 发起人 资助者 担保人
spoon	汤勺 匙
sport	运动 运动会 游戏 开玩笑
sportsman	 运动家,冒险家
spot	点 地点 认出 玷污 沾上污点
spray	飞沫 喷洒剂 浪花 喷洒
spread	展开 传播 涂 展开 传开
spring	春天 春季
spur	马刺 激励 鞭策 鼓舞 促进
square	广场 正方形 正方形的 使正方形
squeeze	挤压 压榨 使挤入 挤过 挤 压
stable	稳定的 牢固的 马厩 培训基地
stack	一垛叠、堆 大量 把…堆起来
stadium	体育场
staff	全体职员 杖 参谋 配备工作人员
stage	舞台 阶段 把…搬上舞台 上演
stain	污点 印迹 玷污 给…着色
stair	常楼梯 阶梯
stake	桩 赌注 利害关系 下赌注
stale	陈腐的 不新鲜的
stamp	邮票 印章 跺脚 盖章于…
stand	站立 站起 放置 使站立 货摊
standard	标准 水平 普通的 一般的 标准的
standpoint	立场 观点
star	恒星 明星 用星号标出 扮演主角
stare	凝视
start	开始 开动 开始 开端 出发
starve	使饿死 使挨饿
state	陈述 阐明 状态 国家 州
statement	陈述 声明 财务报表 申报单
static	静态的 静力的
station	车站 局 所 社会地位 使驻扎
statistic	统计数值
statue	塑像 雕像
status	地位 身份 情形 状况 状态
stay	停留 保持 停留 逗留
steady	稳定的 稳固的
steak	牛排
steal	偷 偷窃 偷偷摸摸地行动
steam	蒸汽 水汽 冒蒸汽热气 蒸煮
steamer	蒸汽汽车 汽船
steel	钢 钢铁 使坚强 使硬起心肠
steep	陡峭的
steer	驾驶 控制方向 使开往
stem	茎 干 柄 把 颈 起源于
step	步 脚步声 步骤 跨步 走
stick	棍 棒 手杖 把…插入 粘住 粘着
sticky	粘的 粘性的 棘手的
stiff	硬的 僵硬的 生硬的 极度地 非常
still	静止的 寂静的 仍然 然而 更 另外
stimulate	刺激 使兴奋 鼓励 鼓舞
sting	叮 刺痛 刺激
stir	调合 激起 微动 微动 轰动
stock	商品存货 股票 备置 贮存
stocking	长袜
stomach	胃 胃口
stone	石头 岩石 水果的核、子
stoop	　．俯身 降低身份
stop	停止 公共汽车站 阻止 停止
storage	贮藏 存储 存储器
store	商店 店铺 贮备品 贮藏 贮备
storey	层 楼
storm	暴风雨 情感的激烈爆发
story	故事 小说 楼层= 新闻报道
stove	炉子 火炉
straight	直的 正直的 笔直地 直接地
strain	张力 紧张 拉绷紧 拉伤
strange	奇怪的 不可思议的 陌生的
stranger	陌生人 外地人 异乡人
strap	带 皮带 用带捆扎
strategic	战略上的 关键的 有重要意义的
strategy	战略 策略 对策 政策
straw	稻草 麦草 吸管
stream	小溪 小河 水流 流 飘扬 招展
street	街道 马路
strength	力量 实力 长处 优点 人力 兵力
strengthen	加强 巩固
stress	压力 压迫 强调 强调
stretch	拉直 拉长 伸展 伸展 一段时间
strict	严格的 严谨的 精确的 严密的
strike	罢工 打击 打 攻击 鸣响 罢工
striking	显著的 吸引人的
string	细绳子 琴弦 一串 把…串在一起
strip	条 脱光衣服 剥夺
stripe	长条 条纹 军服上表示军阶的臂章条纹
stroke	击 敲 报时的钟声 一笔 中风
strong	强有力的 坚强的 强烈的 浓的
structure	结构 构造 建筑物
struggle	挣扎 努力 与…搏斗 挣扎 努力
student	学生 学员
studio	画室 摄影、雕刻等工作室 播音室
study	学习 研究 细看 读书 学习 研究
stuff	材料 原料 填料 填满 塞满
stupid	愚蠢的 笨的
style	风格 文体 时尚 流行式样 种类 类型
subject	主题 学科 从属的 使服从?
submerge	使浸水 使陷入 潜入水中
submit	屈服 呈交 提议 主张
subsequent	继…之后的 后来的
substance	物质 实质 本质 要义 主要部分
substantial	相当的 牢固的 主要的
substitute	代用品 代替者 用…代替 代以
subtract	减去 扣掉
suburb	城郊 郊区
subway	地铁 地下人行道
succeed	成功 继承 接替 接…之后
success	成功 成就 胜利
successful	成功的 有成就的
succession	接连发生 连续 继承权
successive	连续的
such	如此的 如此 这样的人或事物
suck	吸 吮
sudden	突然的 出乎意料的
suffer	遭受 忍受 容忍 受苦 受损失
sufficient	足够的 充分的
sugar	糖
suggest	建议 提议 表明 暗示
suggestion	建议 提议 暗示 示意
suicide	自杀事件 自杀者
suit	适合 中…的意 一套衣服 诉讼
suitable	合适的 适宜的
suitcase	小提箱 衣箱
sum	总数 金额 概要 算术 总计
summarise	概括 总结
summarize	概括 总结
summary	摘要 归纳 简要的 即时的
summer	夏季 夏天
summit	顶峰 最高点 极点 最高级会议
sun	太阳 阳光 恒星
sunday	星期日
sunlight	日光 阳光
sunny	阳光充足的
sunrise	日出
sunset	日落
sunshine	日光 日照
super	超级的 极好的
superb	壮丽的 华丽的 极好的
superficial	表面的 肤浅的 浅薄的
superior	较高的 优越的上级 较好的人或事物
supermarket	超级市场
supper	晚饭
supplement	补充 补充之物 增刊 增补
supply	供应 提供 供应 常供应品
support	支持 支撑物 拥护 支持 鼓励 供养
suppose	假定 料想
supreme	最高的 极度的
sure	肯定的 一定会…的 有信心的
surface	表面 外表 外观
surgery	外科 外科手术 手术室 诊所
surplus	盈余的 过剩 过剩的
surprise	惊讶 惊奇 使诧异 使惊奇 奇袭
surrender	投降 屈服 放弃 交出 投降 认输
surround	包围 环绕 环绕物
surroundings	周围的事物 环境
survey	俯视 眺望 检查 审视 测量
survival	幸存 生存 幸存的人或物
survive	活下来 幸存 从…中逃出
suspect	猜想 可疑的 可疑分子 嫌疑犯
suspend	悬 挂 吊 暂停 中止
suspicion	涉嫌 怀疑 少量 一点儿
sustain	支撑 撑住 经受 忍耐
swallow	吞咽 忍受 吞 咽
sway	摇摆 影响力 支配 摇动
swear	诅咒 咒骂 发誓 宣誓
sweat	汗水 使流汗
sweater	毛衣 绒衣
sweep	打扫 风吹 快速移动 扫描
sweet	甜的 芳香的 和蔼的 糖果
swell	使肿胀 涨大 膨胀 使增长 加大
swift	快的 迅速
swim	游泳 充满 游过 游泳
swing	使摆动 转动 摆动 秋千 转弯
switch	电闸 开关 接通 切断电源 转变
sword	刀剑
symbol	象征 符号 标志
sympathetic	同情的 赞同的
sympathise	同情 体谅
sympathize	同情 体谅
sympathy	同情心 慰问 赞同 支持
symptom	病症 症候 征兆 表征
synthetic	合成的 人工的 综合的 人工制品
system	系统 体系 制度 体制
systematic	成体系的 分类的
table	桌子 表格
tackle	对付 处理 用具 器具 滑车
tag	标签 标牌
tail	尾巴 尾部 跟踪者 尾随 跟踪
tailor	裁缝 缝制 裁剪
take	拿 携带 花费 接受 认为 抓住
tale	故事 传说 谎言
talent	天赋 才能 人才
talk	谈话 谈论 讨论 讲话 交谈
tall	高的 身材高的 有…高的
tame	驯服的
tank	箱 罐 坦克
tap	塞子 开发 轻叩 轻拍
tape	带子 录音录像磁带 把…录于录音
target	靶子 目标 攻击 把…作为目标
task	任务 作业 工作
taste	味道 爱好 品尝 体验 有…味道
tax	税款 对…征税
taxi	计程车 出租车
tea	茶叶 午后茶点
teach	教 教学 教训
teacher	教师 教员
team	队 组
tear	眼泪 撕 撕裂 扯 狂奔
technical	技术性的 工艺的 专门性的
technician	技术员 技师
technique	技巧 手艺 技能 技术
technology	技术 工艺
tedious	冗长乏味的 沉闷的
teenager	13-19岁的青少年
telegram	电报
telephone	电话 打电话
telescope	望远镜
television	电视机
tell	讲 告诉 告诫 劝告 命令 辨别
temper	脾气 情绪 怒气 使缓和 减轻
temperature	温度 发烧
temple	庙宇 寺院
temporary	暂时的 临时的
temptation	引诱 诱惑 迷人之物 诱惑物
ten	十
tend	照料 护理 易于 有某种倾向
tendency	趋势 倾向
tender	嫩的 柔软的 脆弱的 纤细的 温柔的
tennis	网球
tense	拉紧的 绷紧的 紧张的
tension	紧张 拉力 紧张关系 紧张局势
tent	帐篷
term	学期 期限 术语 条件
terminal	末端的 晚期的 终点站 终端机
terrible	可怕的 极度的 糟的 极坏的
territory	领土 地区 领域 范围
terror	恐怖 惊恐
test	试验 测试 检验
text	正文 文本 原文 教科书
textbook	课本 教科书
textile	纺织品 织物
than	比
thank	感谢 感谢
that	那 那个 [引出名词从句]
the	这 那
theater	戏院 剧院
theatre	戏院 剧院
their	[的所有格]他她、它们的
theirs	[的物主代词]他她、它们的
them	[的宾格]他她、它们
theme	话题 主题
themselves	他她、它们自己亲自
then	当时 然后 那么
theoretical	理论上的
theory	理论 看法 见解
therapy	治疗 疗法
there	在那里 在那方面 与连用 表示有
thereby	因此 从而
therefore	因此 所以
thermometer	温度计
these	[的复数]这些
they	他她、它们
thick	厚的 稠的 浓密的 茂密的 厚厚地
thief	贼 小偷
thin	细的 瘦的 稀少的 使变细
thing	物 事情 所有物 情况
think	认为 以为 想要 打算 思考 认为
thinking	思想 思考 思索 思想的 有理性的
third	第三
thirst	口渴
thirsty	口渴的 渴望的 渴求的
thirteen	十三
thirty	三十
this	这 这个
thorough	彻底的 完全的 仔细周到的 精心的
those	[的复数]那些
though	可是 然而 不过 尽管 虽然
thought	想法 看法 思想 思维 打算 意图
thoughtful	沉思的 体贴的 关心的
thousand	一千 许许多多 成千上万
thread	线 思路 螺纹 穿针、线等
threat	威胁 凶兆
threaten	威胁 预示着有…危险
three	三
thrive	兴旺 繁荣
throat	咽喉 嗓子
through	通过 由于 通过 从头到尾
throughout	遍及 贯穿 到处 自始至终
throw	投 扔 抛
thrust	插入 猛推 插 推力 刺 戳 冲
thumb	拇指
thunder	雷 轰隆响 打雷 轰隆响
thursday	星期四
thus	因此 从而 如此 这样
ticket	票 入场券 交通违章罚款单 价格标签
tide	潮 潮汐 潮流 趋势
tidy	整洁的 整齐的 使整洁 使整齐
tie	领带 关系 捆 与…打成平局
tiger	虎
tight	紧的 紧身的 紧紧地 牢牢地
till	直到…为止
timber	木材 木料 梁尤指房梁 船梁
time	时间 次 时期 倍 时代
tin	锡 罐头
tiny	极小的 微小的
tip	梢 末端 尖端 小费 给小费
tire	使感到疲劳
tired	疲倦的 累的 厌倦的 厌烦的
tissue	生物的组织 轻而薄的纸
title	标题 头衔 称号
to	向 往 对 比 直到…为止
toast	祝酒辞;烤面包
tobacco	烟草 烟叶 烟草制品
today	今天 现在 今天 现在
toe	足尖 脚趾
together	共同地 在一起 相互 彼此 一致地
toilet	厕所 洗手间
tolerance	忍耐力受 忍受 容忍
tolerate	宽恕 容忍
tomato	西红柿
tomorrow	在明天 明天 不久的将来
ton	吨重量单位
tone	音色 音调 语调 色调 气氛 调子
tongue	舌头 语言 口语
tonight	在今晚
too	也 还 太 过于
tool	工具
tooth	牙齿 齿
top	顶 最上位 最高的 在…之首
topic	话题 主题
torch	火炬 火把 手电筒
torture	折磨 拷打
total	总的 总数 计算…的总和 总计
touch	触摸 触摸 触动 提到 触觉 触
tough	坚硬的 坚强的 艰难的
tour	旅行
tourist	旅游者 观光者
toward(s)	朝 向 接近 关于 对于
towel	毛巾, 手巾
tower	塔 高楼 高耸
town	市镇 市民 城市商业区 闹市区
toy	玩具
trace	踪迹 痕迹 跟踪 追踪
track	足迹 踪迹 小径 铁轨 跟踪
tractor	拖拉机 牵引车
trade	贸易 行业 做买卖 用…去交换
tradition	传统 惯例 规矩
traffic	交通 流量 指非法物品的交易
tragedy	悲剧戏 悲惨之事
trail	跟踪 追踪 足迹 痕迹 小路
train	火车 列车 训练 培训
training	培训 训练 培养
transfer	转移 转让 迁移 改乘
transform	改变 变形 改造 转换
translate	翻译
translation	翻译 译文 译本
transmission	传递 传送 播送 传动装置
transmit	传播 播送 传递 传导 传送
transparent	透明的
transport	运输 运送
transportation	运输 运送
trap	陷阱 圈套 两轮车 诱捕 使中圈套
trash	．废物 垃圾
travel	旅行 旅行 光、物体等移动 运行
tray	碟 盘
treasure	财宝 宝物 珍品 宝贝 珍惜 珍视
treat	对待 治疗 款待 谈判 宴请 请客
treatment	处理 对待 款待 治疗
treaty	条约
tree	树
tremble	摇晃 颤抖
tremendous	巨大的 极大的 绝好的 极棒的
trend	趋向 趋势 倾向 趋势
trial	审判 审讯 试验
triangle	三角 三角形
trick	诡计 手法 把戏 玩笑 窍门 欺骗
trim	修剪 整修头发、树枝等 整齐的
trip	短程旅行
triumph	胜利 胜利
troop	一群 军队 部队
tropical	热带的
trouble	麻烦 故障 功夫 使烦恼 费神
troublesome	令人烦恼的 麻烦的 讨厌的
trousers	裤子
truck	卡车 载重汽车
true	真实的 诚实的 真的 不假的 准确的
truly	正确地 事实上 真诚地
trumpet	喇叭 小号
trunk	树干 躯干 象鼻
trust	信任 可信任的人或物 相信 委托
truth	事实 实情 真实性 真理
try	尝试 试 审问 尝试 努力
tube	管 管状物 身体上的管状器官 英地铁
tuesday	星期二
tune	调子 曲调 和谐 为乐器调音 调整
tunnel	地道 隧道 管道 挖地道或隧洞
turbine	汽轮机 涡轮机
turn	旋转 转向 转向 转动 转变
tutor	家庭教师 导师 教 指导
twelfth	第十二
twelve	十二
twentieth	第二十
twenty	二十
twice	两次 两倍
twin	孪生的 孪生儿
twist	扭曲 扭伤 缠绕
two	二
type	类型 印刷字体 活字 打字
typewriter	打字机
typical	典型的 有代表性的
typist	打字员
tyre	轮胎
ugly	长相、外貌丑的 讨厌的 可憎的
ultimate	最后的 最终的 根本的 基本的
umbrella	伞 雨伞
uncle	叔叔 伯伯 舅父 姑父
uncover	揭开覆盖物 打开…的包装 使…露出
under	在…下面  在…以下 在下面 少于
undergo	遭受 经历
undergraduate	大学生
underground	地下的 秘密的 地下铁路 地下组织
underline	强调 在…下划线
underneath	在…下面 在下面
understand	理解 听说 得知 认为
understanding	理解力 谅解
undertake	着手做 从事 承担 保证 答应
undo	解开 松开 取消
undoubtedly	不容置疑地 肯定地
uneasy	不安的 担心的 拘束的 不稳定的
unexpected	意外的 没想到的
unfortunately	不幸地 可惜的是
uniform	制服 军装 一致的
union	工会 协会 联合 合并 团结 融洽
unique	唯一的 独特的 独一无二的事物
unit	单位 单元 部队 最小整数
unite	联合 统一 合并 使一致行动
unity	团结 和睦 统一 联合 整体性
universal	普通的 通用的 一般的 全球的 宇宙的
universe	宇宙
university	综合性大学
unless	除非 如果不
unlike	不同的 不象… 和…不同
unload	从卸下货物
until	直到…为止 在…以前 直到…
unusual	不寻常的 独特的
up	向上 起来 向高处
upon	在…上
upper	上面的 地位较高的
upright	竖直的 诚实的 笔直 柱子
upset	打翻 弄翻 扰乱 使不安
upstairs	往在楼上
up-to-date	 直到现在的,最近的,当代的
upward	向上的 上升的 向上 上升
urban	都市的 城市的
urge	强烈愿望 敦促 鼓励 强烈希望
urgent	紧急的 急切的
us	我们[的宾格]
usage	用法 使用 惯用法 习语
use	运用 用途
used	过去常常
useful	有用的 实用的
useless	无用的 无价值的 无效的
user	使用者 用户
usual	通常的 平常的
usually	平常地 通常地
utility	用途 使用价值 公用事业
utilise	利用 使用
utilize	利用 使用
utmost	极度的 最远的 极限 最大可能
utter	说 说出 完全的 十足的 彻底的
vacant	空的 职位等空缺的 茫然的
vacation	假期 休假 空出 腾出
vacuum	真空 真空吸尘器 以真空吸尘器清扫
vague	模糊的 不明确的 说话含糊不清的
vain	徒劳的 空虚的 自负的
valid	有根据的 正确的 有效的
valley	山谷 溪谷
valuable	有价值的 有用的 贵重物品
value	重要性 价值 评价 给…估价
van	有篷货车 运货车
vanish	消失 消散
vapor	蒸汽 雾气
vapour	蒸气 雾气
variable	可变的 易变的 变量
variation	变化 变奏曲
variety	变化 多样化 种种 品种 变种
various	不同的 各种各样的 多方面的
vary	有变化 相异 改变 变更
vast	辽阔的 巨大的
vegetable	蔬菜
vehicle	交通工具 车辆 工具 手段
venture	冒险行为 冒险 大胆提出
verb	动词
verify	证实 证明 查清 核实
version	译文 译本 版本 看法
vertical	垂直的 竖的
very	很 十分 恰好 真正的 十足的
vessel	船只 容器 器皿 血管 导管
veteran	老兵 退伍军人 老手 老练的
via	经 经由 通过
vibrate	使震动 使摇摆
vice	坏事 罪恶 不道德 缺点 老虎钳
victim	受害者 牺牲者 遇难者
victory	胜利 获胜
video	电视 录像 电视的 录像的
view	风景 看法 视野 把…看成是
viewpoint	观点 看法 见解
vigorous	精力充沛的
village	乡村, 村庄
vinegar	醋
violate	违犯 违反 妨碍 扰乱 亵渎
violence	暴力 强暴 剧烈 强烈
violent	剧烈的 猛力的 强暴的 由暴力引起的
violet	紫罗兰 紫色的
violin	小提琴
virtual	实际上的
virtually	事实上 几乎 实行上
virtue	美德 德行 优点
virus	病毒
visible	看得见的 可见的 明显的
vision	视力 视觉 远见 眼光 想象力
visit	访问 参观 视察 巡回
visitor	访问者 来宾 参观者
visual	视觉的 可见的
vital	生命的 有活力的 致命的 至关重要的
vitamin	维生素
vivid	生动的 逼真的 颜色鲜艳的
vocabulary	词汇量 词汇表
voice	嗓音 声音 意见 语态 表达
volcano	火山
volleyball	排球运动
volt	伏特 伏
voltage	电压
volume	音量 容积 容量 书卷 卷册
voluntary	自愿的 志愿的
volunteer	自愿者 自告奋勇去做 自愿
vote	选票 选举权 投票 公认
voyage	航海 航行 旅行 航海 航行
wage	报酬 工资
waggon	四轮马车
wagon	四轮马车 大蓬货车 小推车
waist	腰部 腰
wait	等待 等 等候
waiter	男侍者 男服务员
wake	唤醒 唤起 使认识到 醒来
waken	醒来 弄醒 叫醒
walk	步行 散步
wall	墙 围墙
wander	漫游 漫步 走神 神志恍惚
want	需要 缺乏 想要 需要 缺乏 缺少
war	战争 战斗
warm	温暖的 热情的 保暖的 使温暖
warmth	温暖 热忱
warn	警告 告诫
wash	洗 冲 洗手 洗衣 耐洗 洗涤
waste	浪费 废物 浪费 消耗 废的
watch	看管 手表 观看 监视 注意
water	水 给…浇水
waterproof	耐水的 防水的
wave	挥动 飘动 挥动 挥手 招手
wax	蜡 蜂蜡 给…打蜡
way	道路 方向 方法 距离 点
we	我们
weak	身体方面虚弱 性格上软弱
weaken	削弱 使变弱
weakness	虚弱 衰弱 软弱 缺点 弱点
wealth	财产 财富 大量 丰富
wealthy	富裕的 丰富的
weapon	武器 兵器
wear	穿着 戴着 磨损 耗损
weather	天气 气候
weave	织 编
wedding	婚礼
wednesday	星期三
weed	杂草 野草 除草
week	星期 周
weekday	平常日 工作日
weekend	周末
weekly	每周的 一周一次地 周报
weep	哭泣 流泪
weigh	称…的重量 权衡 重若干
weight	重量 砝码 重压 重要性
welcome	受欢迎的 欢迎
weld	．焊接 熔接 结合
welfare	幸福 康乐 福利
well	哎呀 好 完全地 良好的
well-known	 众所周知的,有名的
west	西方 西部 向西方 西方的
western	西方的 西部的 美国西部小说电影
wet	湿的 多雨的 把…打湿 雨 潮气
whale	鲸
what	什么 多么 什么 尽量多的
whatever	无论什么 不管怎么样的
whatsoever	 无论什么
wheat	小麦
wheel	轮子 推动 突然
when	什么时候 在…时 什么时候
whenever	无论何时 每当
where	在哪里 在那里 然而 哪里
whereas	鉴于 然而 但是 尽管
wherever	无论在到哪里 无论去什么地方
whether	是否 会不会 不管 无论
which	哪一个 哪一个 哪一些
whichever	无论哪个 无论哪些
while	当…的时候 而 一会儿
whilst	 当的时候
whip	鞭子 鞭打 击败 快速或突然移动
whisper	低语 耳语 私下说 低语 耳语
whistle	用口哨喵吹奏 吹口哨 口哨声
white	白色的 白种的 白色 白种人
who	谁
whoever	无论谁 不管谁 究竟是谁
whole	全部 全体的 完整的
wholly	完全地
whom	[的宾格]谁的
whose	谁的 哪个人的 哪些人的
why	为什么 …的理由 哎呀
wicked	邪恶的 坏的 顽皮的
wide	宽阔的 广泛的 全部地 充分地
widen	加宽 放宽
widespread	普遍的 分布或散布广的
widow	寡妇
width	宽度 一幅布料 宽广
wife	妻子 夫人 太太
wild	野生的 未开化的 凶猛的 狂热的
will	将 愿意 要 意志 愿望 遗嘱
willing	愿意的 心甘情愿的
win	赢得 在…中获胜 赢 胜利
wind	风 气息 呼吸
window	窗户 窗口
wine	葡萄酒
wing	翼 舞台两边 侧翼
winter	冬季 冬天
wipe	擦 抹 揩 擦 抹 揩
wire	电线 电报 给…发电报 发电报
wisdom	智慧 古训 至理名言
wise	聪明的 明智的
wish	祝愿 希望 愿望 但愿 企盼
wit	机智 智力 健全的头脑
with	和…在一起 用 具有 关于 因
withdraw	收回 撤退 退出 提取款项 撤销
within	在…里面 在里面
without	没有
withstand	抵抗, 经受住
witness	目击者 证据 目击 为…作证 证明
wolf	狼
woman	妇女 成年女子
wonder	惊异 奇事 想知道 对…感到惊讶
wonderful	极好的 极棒的 惊人的 奇妙的
wood	木材 木料 小树林
wooden	木制的 呆笨的
wool	羊毛 毛线 毛织品
word	词 词语 言语 话 谈话 消息 信息
work	工作 职业 工作 起作用 使工作
worker	工人 工作者
workman	工人 劳动者 工匠
workshop	车间 工场 修理厂 研讨会 讲习班
world	世界 地球 世上的人 阶层 领域
worldwide	遍及地球的 世界范围的
worm	蠕虫 懦夫 不受尊重的人
worry	担心 令人烦恼的事或人 使担心
worse	更坏 更厉害 更糟
worship	礼拜 崇拜 做礼拜 崇拜
worst	最坏的 最差的 最坏地 最差地
worth	值多少钱 值得
worthless	无价值的 无用的
worthwhile	值得干的 有价值的
worthy	值得尊敬的 值得…的
would	将 可能 总是 宁愿
wound	伤 伤口 使受伤 伤害
wrap	披肩 围巾 包 裹
wreck	沉船 毁灭 船只等失事 使失事
wrist	腕 腕关节
write	写 书写 写字 写作 写信给
writer	作者 作家
writing	写作 常作品 笔迹 字迹
wrong	错误的 有毛病的 错误地 坏事
x-ray	 X光照片
yard	码 院子 庭院
yawn	呵欠 打呵欠
year	年 年度 学年
yearly	每年 一年一度
yellow	黄的 黄色的 黄色
yes	是 是的
yesterday	昨天
yet	然而 到目前为止 更 还
yield	屈服 崩垮 产生 放弃
you	你 你们 一个人 任何人
young	年轻的 青年的 年轻人
youngster	小伙子 年轻人 少年 儿童
your	你的 你们的
yours	你们的所有物
yourself	你们自己 你们亲自
yourselves	 你们自己
youth	青春 总称青年们 男年轻人
zero	零 零点 无
zone	地区 地带 区域
zoo	动物园
zo	动物园
zo	动物园